date,day,home_team,home_team_,away_team,away_team_,home_score,away_score,tournament,city,country,year,year_n,month,home_result,away_result,result,total_goals,home_result_desc,away_result_desc,serial,decade,home_group,away_group,home_random,away_random
10/02/1957,10,Sudan,Sudan,Egypt,Egypt,1,2,African Cup of Nations,Khartoum,Sudan,1957,7,2,-1,1,1,3,loser,winner,1,1,1,1,0.48106548,0.737720969
17/02/1957,17,Sudan,Sudan,Egypt,Egypt,3,4,Friendly,Khartoum,Sudan,1957,7,2,-1,1,1,7,loser,winner,2,1,1,1,0.90727885,0.152371585
08/03/1957,8,Sudan,Sudan,Syria,Syria,1,0,FIFA World Cup qualification,Khartoum,Sudan,1957,7,3,1,-1,1,1,winner,loser,3,1,1,0,0.41440975,0.229913097
24/05/1957,24,Syria,Syria,Sudan,Sudan,1,1,FIFA World Cup qualification,Damascus,Syria,1957,7,5,0,0,0,2,draw,draw,4,1,0,1,0.37185405,0.617235233
02/06/1957,2,Tunisia,Tunisia,Libya,Libya,4,2,Friendly,Tunis,Tunisia,1957,7,6,2,-2,2,6,winner,loser,5,1,1,0,0.09837726,0.156429602
03/04/1958,3,Morocco,Morocco,Libya,Libya,3,1,Friendly,Casablanca,Morocco,1958,8,4,2,-2,2,4,winner,loser,6,1,0,0,0.17301631,0.339381324
09/05/1958,9,Tunisia,Tunisia,Libya,Libya,4,1,Friendly,Tunis,Tunisia,1958,8,5,3,-3,3,5,winner,loser,7,1,1,0,0.75866195,0.97993179
29/05/1959,29,Egypt,Egypt,Sudan,Sudan,2,1,African Cup of Nations,Cairo,United Arab Republic,1959,9,5,1,-1,1,3,winner,loser,8,1,1,1,0.74888634,0.542249327
05/06/1960,5,Tunisia,Tunisia,Iraq,Iraq,2,1,Friendly,Tunis,Tunisia,1960,0,6,1,-1,1,3,winner,loser,9,1,1,0,0.07806237,0.475085667
30/10/1960,30,Morocco,Morocco,Tunisia,Tunisia,2,1,FIFA World Cup qualification,Casablanca,Morocco,1960,0,10,1,-1,1,3,winner,loser,10,1,0,1,0.59604626,0.260560315
13/11/1960,13,Tunisia,Tunisia,Morocco,Morocco,2,1,FIFA World Cup qualification,Tunis,Tunisia,1960,0,11,1,-1,1,3,winner,loser,11,1,1,0,0.27777704,0.789354838
23/12/1960,23,Iraq,Iraq,Tunisia,Tunisia,3,2,Friendly,Baghdad,Iraq,1960,0,12,1,-1,1,5,winner,loser,12,1,0,1,0.53521919,0.080267883
22/02/1961,22,Morocco,Morocco,Tunisia,Tunisia,1,1,FIFA World Cup qualification,Palermo,Italy,1961,1,2,0,0,0,2,draw,draw,13,2,0,1,0.71359145,0.768873488
11/03/1962,11,Libya,Libya,Tunisia,Tunisia,6,3,Friendly,Tripoli,Libya,1962,2,3,3,-3,3,9,winner,loser,14,2,0,1,0.2248067,0.40670467
03/06/1962,3,Tunisia,Tunisia,Libya,Libya,2,2,Friendly,Tunis,Tunisia,1962,2,6,0,0,0,4,draw,draw,15,2,1,0,0.87418118,0.105958277
06/01/1963,6,Kuwait,Kuwait,Jordan,Jordan,2,1,Friendly,Kuwait City,Kuwait,1963,3,1,1,-1,1,3,winner,loser,16,2,0,1,0.0881714,0.39993026
03/03/1963,3,Tunisia,Tunisia,Kuwait,Kuwait,2,1,Friendly,Tunis,Tunisia,1963,3,3,1,-1,1,3,winner,loser,17,2,1,0,0.04467656,0.84214577
31/03/1963,31,Lebanon,Lebanon,Kuwait,Kuwait,6,0,UAFA Cup,Beirut,Lebanon,1963,3,3,6,-6,6,6,winner,loser,18,2,1,0,0.28403425,0.338840098
02/04/1963,2,Syria,Syria,Tunisia,Tunisia,0,1,UAFA Cup,Beirut,Lebanon,1963,3,4,-1,1,1,1,loser,winner,19,2,0,1,0.23747755,0.31524677
04/04/1963,4,Jordan,Jordan,Tunisia,Tunisia,0,4,UAFA Cup,Beirut,Lebanon,1963,3,4,-4,4,4,4,loser,winner,20,2,1,1,0.25259274,0.249420375
06/04/1963,6,Kuwait,Kuwait,Tunisia,Tunisia,1,5,UAFA Cup,Beirut,Lebanon,1963,3,4,-4,4,4,6,loser,winner,21,2,0,1,0.18556777,0.955191304
06/04/1963,6,Lebanon,Lebanon,Jordan,Jordan,5,0,UAFA Cup,Beirut,Lebanon,1963,3,4,5,-5,5,5,winner,loser,22,2,1,1,0.4308479,0.047353799
07/04/1963,7,Kuwait,Kuwait,Syria,Syria,0,4,UAFA Cup,Beirut,Lebanon,1963,3,4,-4,4,4,4,loser,winner,23,2,0,0,0.86717819,0.068053974
07/04/1963,7,Lebanon,Lebanon,Tunisia,Tunisia,0,1,UAFA Cup,Beirut,Lebanon,1963,3,4,-1,1,1,1,loser,winner,24,2,1,1,0.00086479,0.115828651
09/06/1963,9,Tunisia,Tunisia,Lebanon,Lebanon,2,0,Friendly,Tunis,Tunisia,1963,3,6,2,-2,2,2,winner,loser,25,2,1,1,0.9324927,0.222047373
02/07/1963,2,Morocco,Morocco,Tunisia,Tunisia,4,2,African Cup of Nations qualification,Casablanca,Morocco,1963,3,7,2,-2,2,6,winner,loser,26,2,0,1,0.03950452,0.944538034
07/07/1963,7,Algeria,Algeria,Egypt,Egypt,2,2,Friendly,Oran,Algeria,1963,3,7,0,0,0,4,draw,draw,27,2,1,1,0.46037626,0.082661538
30/03/1970,30,Bahrain,Bahrain,Saudi Arabia,Saudi_Arabia,0,0,Gulf Cup,Isa Town,Bahrain,1970,0,3,0,0,0,0,draw,draw,98,3,0,0,0.86416832,0.757488119
26/11/1963,26,Egypt,Egypt,Sudan,Sudan,2,2,African Cup of Nations,Kumasi,Ghana,1963,3,11,0,0,0,4,draw,draw,29,2,1,1,0.62554246,0.123229948
15/12/1963,15,Tunisia,Tunisia,Algeria,Algeria,0,0,Friendly,Tunis,Tunisia,1963,3,12,0,0,0,0,draw,draw,30,2,1,1,0.01420705,0.032041645
08/03/1964,8,Libya,Libya,Lebanon,Lebanon,0,1,Friendly,Tripoli,Libya,1964,4,3,-1,1,1,1,loser,winner,31,2,0,1,0.8923957,0.654478929
20/03/1964,20,Egypt,Egypt,Algeria,Algeria,1,0,Friendly,Cairo,Egypt,1964,4,3,1,-1,1,1,winner,loser,32,2,1,1,0.65234193,0.032167917
13/11/1964,13,Jordan,Jordan,Lebanon,Lebanon,0,0,UAFA Cup,Kuwait City,Kuwait,1964,4,11,0,0,0,0,draw,draw,33,2,1,1,0.96464055,0.551133338
13/11/1964,13,Kuwait,Kuwait,Iraq,Iraq,0,1,UAFA Cup,Kuwait City,Kuwait,1964,4,11,-1,1,1,1,loser,winner,34,2,0,0,0.24347977,0.661438353
15/11/1964,15,Kuwait,Kuwait,Jordan,Jordan,2,0,UAFA Cup,Kuwait City,Kuwait,1964,4,11,2,-2,2,2,winner,loser,35,2,0,1,0.89598285,0.050280788
15/11/1964,15,Libya,Libya,Lebanon,Lebanon,2,1,UAFA Cup,Kuwait City,Kuwait,1964,4,11,1,-1,1,3,winner,loser,36,2,0,1,0.40308067,0.335517987
16/11/1964,16,Kuwait,Kuwait,Libya,Libya,1,1,UAFA Cup,Kuwait City,Kuwait,1964,4,11,0,0,0,2,draw,draw,37,2,0,0,0.03789931,0.684556607
17/11/1964,17,Iraq,Iraq,Lebanon,Lebanon,1,0,UAFA Cup,Kuwait City,Kuwait,1964,4,11,1,-1,1,1,winner,loser,38,2,0,1,0.31881424,0.146264568
17/11/1964,17,Jordan,Jordan,Libya,Libya,2,5,UAFA Cup,Kuwait City,Kuwait,1964,4,11,-3,3,3,7,loser,winner,39,2,1,0,0.26640486,0.629691526
19/11/1964,19,Kuwait,Kuwait,Lebanon,Lebanon,2,3,UAFA Cup,Kuwait City,Kuwait,1964,4,11,-1,1,1,5,loser,winner,40,2,0,1,0.01343218,0.403666847
28/02/1965,28,Tunisia,Tunisia,Morocco,Morocco,0,0,Friendly,Tunis,Tunisia,1965,5,2,0,0,0,0,draw,draw,41,2,1,0,0.35577571,0.137977452
12/03/1965,12,Kuwait,Kuwait,Morocco,Morocco,0,2,Friendly,Tripoli,Libya,1965,5,3,-2,2,2,2,loser,winner,42,2,0,0,0.87498141,0.220071884
14/03/1965,14,Libya,Libya,Kuwait,Kuwait,4,1,Friendly,Tripoli,Libya,1965,5,3,3,-3,3,5,winner,loser,43,2,0,0,0.64348969,0.982232691
19/03/1965,19,Libya,Libya,Morocco,Morocco,1,0,Friendly,Tripoli,Libya,1965,5,3,1,-1,1,1,winner,loser,44,2,0,0,0.25601708,0.772501122
02/05/1965,2,Morocco,Morocco,Tunisia,Tunisia,0,1,Friendly,Casablanca,Morocco,1965,5,5,-1,1,1,1,loser,winner,45,2,0,1,0.01358908,0.27179077
30/07/1965,30,Jordan,Jordan,Iraq,Iraq,0,0,Friendly,Amman,Jordan,1965,5,7,0,0,0,0,draw,draw,46,2,1,0,0.24759707,0.801612826
31/10/1965,31,Algeria,Algeria,Morocco,Morocco,0,0,Friendly,Algiers,Algeria,1965,5,10,0,0,0,0,draw,draw,47,2,1,0,0.61419243,0.115292948
06/03/1966,6,Morocco,Morocco,Algeria,Algeria,1,0,Friendly,Casablanca,Morocco,1966,6,3,1,-1,1,1,winner,loser,48,2,0,1,0.92486413,0.780468108
11/03/1966,11,Libya,Libya,Morocco,Morocco,4,0,Friendly,Tripoli,Libya,1966,6,3,4,-4,4,4,winner,loser,49,2,0,0,0.37926997,0.582542783
14/03/1966,14,Libya,Libya,Iraq,Iraq,0,2,Friendly,Tripoli,Libya,1966,6,3,-2,2,2,2,loser,winner,50,2,0,0,0.42594083,0.671616716
18/03/1966,18,Iraq,Iraq,Morocco,Morocco,0,1,Friendly,Tripoli,Libya,1966,6,3,-1,1,1,1,loser,winner,51,2,0,0,0.33845419,0.594813128
19/03/1966,19,Iraq,Iraq,Morocco,Morocco,1,2,Friendly,Tripoli,Libya,1966,6,3,-1,1,1,3,loser,winner,52,2,0,0,0.08044283,0.392636857
01/04/1966,1,Bahrain,Bahrain,Kuwait,Kuwait,4,4,UAFA Cup,Baghdad,Iraq,1966,6,4,0,0,0,8,draw,draw,53,2,0,0,0.46832572,0.990053274
01/04/1966,1,Iraq,Iraq,Lebanon,Lebanon,0,0,UAFA Cup,Baghdad,Iraq,1966,6,4,0,0,0,0,draw,draw,54,2,0,1,0.64308129,0.869468592
02/04/1966,2,Libya,Libya,Palestine,Palestine,0,0,UAFA Cup,Baghdad,Iraq,1966,6,4,0,0,0,0,draw,draw,55,2,0,0,0.33941924,0.395022971
02/04/1966,2,Syria,Syria,Yemen,Yemen,4,1,UAFA Cup,Baghdad,Iraq,1966,6,4,3,-3,3,5,winner,loser,56,2,0,1,0.00144116,0.644570941
03/04/1966,3,Bahrain,Bahrain,Lebanon,Lebanon,1,6,UAFA Cup,Baghdad,Iraq,1966,6,4,-5,5,5,7,loser,winner,57,2,0,1,0.40569729,0.172503607
03/04/1966,3,Iraq,Iraq,Jordan,Jordan,2,1,UAFA Cup,Baghdad,Iraq,1966,6,4,1,-1,1,3,winner,loser,58,2,0,1,0.80356545,0.423107258
04/04/1966,4,Libya,Libya,Syria,Syria,0,0,UAFA Cup,Baghdad,Iraq,1966,6,4,0,0,0,0,draw,draw,59,2,0,0,0.95564446,0.782841346
04/04/1966,4,Palestine,Palestine,Yemen,Yemen,7,0,UAFA Cup,Baghdad,Iraq,1966,6,4,7,-7,7,7,winner,loser,60,2,0,1,0.34639142,0.178434135
05/04/1966,5,Iraq,Iraq,Kuwait,Kuwait,3,1,UAFA Cup,Baghdad,Iraq,1966,6,4,2,-2,2,4,winner,loser,61,2,0,0,0.94640828,0.054250369
05/04/1966,5,Jordan,Jordan,Lebanon,Lebanon,1,2,UAFA Cup,Baghdad,Iraq,1966,6,4,-1,1,1,3,loser,winner,62,2,1,1,0.66339359,0.903990439
06/04/1966,6,Libya,Libya,Yemen,Yemen,14,0,UAFA Cup,Baghdad,Iraq,1966,6,4,14,-14,14,14,winner,loser,63,2,0,1,0.46716302,0.783590443
06/04/1966,6,Palestine,Palestine,Syria,Syria,1,3,UAFA Cup,Baghdad,Iraq,1966,6,4,-2,2,2,4,loser,winner,64,2,0,0,0.40890327,0.053357387
07/04/1966,7,Iraq,Iraq,Bahrain,Bahrain,10,1,UAFA Cup,Baghdad,Iraq,1966,6,4,9,-9,9,11,winner,loser,65,2,0,0,0.08040813,0.407796785
07/04/1966,7,Jordan,Jordan,Kuwait,Kuwait,2,2,UAFA Cup,Baghdad,Iraq,1966,6,4,0,0,0,4,draw,draw,66,2,1,0,0.1190751,0.707719278
08/04/1966,8,Iraq,Iraq,Libya,Libya,3,1,UAFA Cup,Baghdad,Iraq,1966,6,4,2,-2,2,4,winner,loser,67,2,0,0,0.56384711,0.027725122
08/04/1966,8,Lebanon,Lebanon,Syria,Syria,0,1,UAFA Cup,Baghdad,Iraq,1966,6,4,-1,1,1,1,loser,winner,68,2,1,0,0.872115,0.718228018
09/04/1966,9,Bahrain,Bahrain,Jordan,Jordan,1,2,UAFA Cup,Baghdad,Iraq,1966,6,4,-1,1,1,3,loser,winner,69,2,0,1,0.95646486,0.782307826
09/04/1966,9,Kuwait,Kuwait,Lebanon,Lebanon,1,2,UAFA Cup,Baghdad,Iraq,1966,6,4,-1,1,1,3,loser,winner,70,2,0,1,0.87787158,0.144242223
10/04/1966,10,Iraq,Iraq,Syria,Syria,2,1,UAFA Cup,Baghdad,Iraq,1966,6,4,1,-1,1,3,winner,loser,71,2,0,0,0.86346451,0.114216318
10/04/1966,10,Libya,Libya,Lebanon,Lebanon,6,1,UAFA Cup,Baghdad,Iraq,1966,6,4,5,-5,5,7,winner,loser,72,2,0,1,0.85037523,0.750488165
24/11/1966,24,Algeria,Algeria,Morocco,Morocco,2,2,Friendly,Algiers,Algeria,1966,6,11,0,0,0,4,draw,draw,73,2,1,0,0.77212035,0.328896364
25/11/1966,25,Palestine,Palestine,Yemen,Yemen,5,3,GaNEFo,Phnom Penh,Cambodia,1966,6,11,2,-2,2,8,winner,loser,74,2,0,1,0.87103506,0.016632863
09/12/1966,9,Libya,Libya,Egypt,Egypt,2,2,African Cup of Nations qualification,Tripoli,Libya,1966,6,12,0,0,0,4,draw,draw,75,2,0,1,0.43418279,0.005381701
07/03/1967,7,Libya,Libya,Sudan,Sudan,1,1,Friendly,Tripoli,Libya,1967,7,3,0,0,0,2,draw,draw,76,2,0,1,0.88115893,0.982293285
10/03/1967,10,Iraq,Iraq,Sudan,Sudan,2,2,Friendly,Tripoli,Libya,1967,7,3,0,0,0,4,draw,draw,77,2,0,1,0.00759754,0.951284464
12/03/1967,12,Libya,Libya,Iraq,Iraq,0,1,Friendly,Tripoli,Libya,1967,7,3,-1,1,1,1,loser,winner,78,2,0,0,0.40685973,0.35829492
28/03/1970,28,Saudi Arabia,Saudi_Arabia,Kuwait,Kuwait,1,3,Gulf Cup,Isa Town,Bahrain,1970,0,3,-2,2,2,4,loser,winner,97,3,0,0,0.58097776,0.965878435
17/03/1968,17,Morocco,Morocco,Algeria,Algeria,0,0,Friendly,Casablanca,Morocco,1968,8,3,0,0,0,0,draw,draw,80,2,0,1,0.2539431,0.342892823
17/11/1968,17,Algeria,Algeria,Tunisia,Tunisia,1,2,FIFA World Cup qualification,Algiers,Algeria,1968,8,11,-1,1,1,3,loser,winner,81,2,1,1,0.50079097,0.296430429
29/12/1968,29,Tunisia,Tunisia,Algeria,Algeria,0,0,FIFA World Cup qualification,Tunis,Tunisia,1968,8,12,0,0,0,0,draw,draw,82,2,1,1,0.47823314,0.242033436
09/03/1969,9,Algeria,Algeria,Morocco,Morocco,2,0,African Cup of Nations qualification,Algiers,Algeria,1969,9,3,2,-2,2,2,winner,loser,83,2,1,0,0.64450593,0.066703352
27/04/1969,27,Tunisia,Tunisia,Morocco,Morocco,0,0,FIFA World Cup qualification,Tunis,Tunisia,1969,9,4,0,0,0,0,draw,draw,84,2,1,0,0.79321913,0.382039882
18/05/1969,18,Morocco,Morocco,Tunisia,Tunisia,0,0,FIFA World Cup qualification,Casablanca,Morocco,1969,9,5,0,0,0,0,draw,draw,85,2,0,1,0.17819098,0.43518825
13/06/1969,13,Tunisia,Tunisia,Morocco,Morocco,2,2,FIFA World Cup qualification,Marseille,France,1969,9,6,0,0,0,4,draw,draw,86,2,1,0,0.18251334,0.937083981
19/09/1969,19,Egypt,Egypt,Algeria,Algeria,1,0,African Cup of Nations qualification,Cairo,Egypt,1969,9,9,1,-1,1,1,winner,loser,87,2,1,1,0.15654672,0.226932958
28/09/1969,28,Algeria,Algeria,Egypt,Egypt,1,1,African Cup of Nations qualification,Algiers,Algeria,1969,9,9,0,0,0,2,draw,draw,88,2,1,1,0.30744642,0.044093315
10/10/1969,10,Sudan,Sudan,Morocco,Morocco,0,0,FIFA World Cup qualification,Khartoum,Sudan,1969,9,10,0,0,0,0,draw,draw,89,2,1,0,0.75998745,0.19881198
15/10/1969,15,Tunisia,Tunisia,Palestine,Palestine,1,1,Friendly,Tunis,Tunisia,1969,9,10,0,0,0,2,draw,draw,90,2,1,0,0.75743485,0.376301882
23/10/1969,23,Algeria,Algeria,Palestine,Palestine,2,0,Friendly,Algiers,Algeria,1969,9,10,2,-2,2,2,winner,loser,91,2,1,0,0.51772979,0.680379246
26/10/1969,26,Morocco,Morocco,Sudan,Sudan,3,0,FIFA World Cup qualification,Casablanca,Morocco,1969,9,10,3,-3,3,3,winner,loser,92,2,0,1,0.56261936,0.615616054
30/10/1969,30,Algeria,Algeria,Morocco,Morocco,1,0,Friendly,Algiers,Algeria,1969,9,10,1,-1,1,1,winner,loser,93,2,1,0,0.90455252,0.338647622
02/11/1969,2,Egypt,Egypt,Sudan,Sudan,3,1,Friendly,Cairo,Egypt,1969,9,11,2,-2,2,4,winner,loser,94,2,1,1,0.61863609,0.609746718
14/02/1970,14,Sudan,Sudan,Egypt,Egypt,2,1,African Cup of Nations,Khartoum,Sudan,1970,0,2,1,-1,1,3,winner,loser,95,3,1,1,0.9631525,0.376211977
27/03/1970,27,Bahrain,Bahrain,Qatar,Qatar,2,1,Gulf Cup,Isa Town,Bahrain,1970,0,3,1,-1,1,3,winner,loser,96,3,0,1,0.47420907,0.30506105
02/04/1970,2,Saudi Arabia,Saudi_Arabia,Qatar,Qatar,1,1,Gulf Cup,Isa Town,Bahrain,1970,0,4,0,0,0,2,draw,draw,100,3,0,1,0.64210136,0.847830486
16/03/1974,16,Qatar,Qatar,Saudi Arabia,Saudi_Arabia,0,2,Gulf Cup,Kuwait City,Kuwait,1974,4,3,-2,2,2,2,loser,winner,198,3,1,0,0.88157059,0.878943467
31/03/1970,31,Kuwait,Kuwait,Qatar,Qatar,4,2,Gulf Cup,Isa Town,Bahrain,1970,0,3,2,-2,2,6,winner,loser,99,3,0,1,0.31237909,0.463474024
16/03/1972,16,Saudi Arabia,Saudi_Arabia,Kuwait,Kuwait,2,2,Gulf Cup,Riyadh,Saudi Arabia,1972,2,3,0,0,0,4,draw,draw,150,3,0,0,0.81984294,0.625500935
03/04/1970,3,Bahrain,Bahrain,Kuwait,Kuwait,1,3,Gulf Cup,Isa Town,Bahrain,1970,0,4,-2,2,2,4,loser,winner,101,3,0,0,0.89633012,0.251611759
01/09/1970,1,Libya,Libya,Tunisia,Tunisia,2,2,Friendly,Benghazi,Libya,1970,0,9,0,0,0,4,draw,draw,102,3,0,1,0.74301294,0.389358369
04/09/1970,4,Libya,Libya,Tunisia,Tunisia,3,2,Friendly,Tripoli,Libya,1970,0,9,1,-1,1,5,winner,loser,103,3,0,1,0.29879026,0.051024676
24/09/1970,24,Tunisia,Tunisia,Libya,Libya,2,0,Friendly,Tunis,Tunisia,1970,0,9,2,-2,2,2,winner,loser,104,3,1,0,0.27766283,0.693336099
10/12/1970,10,Algeria,Algeria,Morocco,Morocco,3,1,African Cup of Nations qualification,Algiers,Algeria,1970,0,12,2,-2,2,4,winner,loser,105,3,1,0,0.48697212,0.524406211
27/12/1970,27,Libya,Libya,Egypt,Egypt,0,1,African Cup of Nations qualification,Tripoli,Libya,1970,0,12,-1,1,1,1,loser,winner,106,3,0,1,0.02279781,0.681766769
27/12/1970,27,Morocco,Morocco,Algeria,Algeria,3,0,African Cup of Nations qualification,Casablanca,Morocco,1970,0,12,3,-3,3,3,winner,loser,107,3,0,1,0.26764996,0.929608299
03/01/1971,3,Egypt,Egypt,Libya,Libya,2,1,African Cup of Nations qualification,Cairo,Egypt,1971,1,1,1,-1,1,3,winner,loser,108,3,1,0,0.78353196,0.094077833
28/01/1971,28,Kuwait,Kuwait,Iraq,Iraq,0,2,Friendly,Kuwait City,Kuwait,1971,1,1,-2,2,2,2,loser,winner,109,3,0,0,0.33623217,0.241202026
09/07/1971,9,Libya,Libya,Syria,Syria,2,1,Friendly,Benghazi,Libya,1971,1,7,1,-1,1,3,winner,loser,110,3,0,0,0.15886884,0.146810724
11/07/1971,11,Egypt,Egypt,Syria,Syria,1,0,Friendly,Benghazi,Libya,1971,1,7,1,-1,1,1,winner,loser,111,3,1,0,0.07727819,0.46918346
11/07/1971,11,Sudan,Sudan,Palestine,Palestine,1,1,Friendly,Tripoli,Libya,1971,1,7,0,0,0,2,draw,draw,112,3,1,0,0.67587345,0.007556942
13/07/1971,13,Libya,Libya,Egypt,Egypt,0,2,Friendly,Benghazi,Libya,1971,1,7,-2,2,2,2,loser,winner,113,3,0,1,0.91672509,0.950884402
16/07/1971,16,Libya,Libya,Sudan,Sudan,4,6,Friendly,Benghazi,Libya,1971,1,7,-2,2,2,10,loser,winner,114,3,0,1,0.2404535,0.619938802
18/07/1971,18,Libya,Libya,Egypt,Egypt,2,0,Friendly,Tripoli,Libya,1971,1,7,2,-2,2,2,winner,loser,115,3,0,1,0.80536474,0.639922057
19/11/1971,19,Iraq,Iraq,Kuwait,Kuwait,3,1,Friendly,Baghdad,Iraq,1971,1,11,2,-2,2,4,winner,loser,116,3,0,0,0.41068624,0.564923142
24/11/1971,24,Libya,Libya,Algeria,Algeria,0,0,Friendly,Tripoli,Libya,1971,1,11,0,0,0,0,draw,draw,117,3,0,1,0.01070392,0.94161767
10/12/1971,10,Kuwait,Kuwait,Iraq,Iraq,1,1,AFC Asian Cup qualification,Kuwait City,Kuwait,1971,1,12,0,0,0,2,draw,draw,118,3,0,0,0.99709258,0.009250736
11/12/1971,11,Bahrain,Bahrain,Lebanon,Lebanon,3,0,AFC Asian Cup qualification,Kuwait City,Kuwait,1971,1,12,3,-3,3,3,winner,loser,119,3,0,1,0.14765497,0.545420963
11/12/1971,11,Syria,Syria,Jordan,Jordan,0,0,AFC Asian Cup qualification,Kuwait City,Kuwait,1971,1,12,0,0,0,0,draw,draw,120,3,0,1,0.86928088,0.041488195
13/12/1971,13,Jordan,Jordan,Bahrain,Bahrain,3,2,AFC Asian Cup qualification,Kuwait City,Kuwait,1971,1,12,1,-1,1,5,winner,loser,121,3,1,0,0.30807563,0.107597218
14/12/1971,14,Kuwait,Kuwait,Lebanon,Lebanon,1,0,AFC Asian Cup qualification,Kuwait City,Kuwait,1971,1,12,1,-1,1,1,winner,loser,122,3,0,1,0.91569656,0.824196379
15/12/1971,15,Iraq,Iraq,Bahrain,Bahrain,1,0,AFC Asian Cup qualification,Kuwait City,Kuwait,1971,1,12,1,-1,1,1,winner,loser,123,3,0,0,0.99675535,0.545520252
17/12/1971,17,Kuwait,Kuwait,Syria,Syria,2,2,AFC Asian Cup qualification,Kuwait City,Kuwait,1971,1,12,0,0,0,4,draw,draw,124,3,0,0,0.49587085,0.643519086
18/12/1971,18,Iraq,Iraq,Jordan,Jordan,2,0,AFC Asian Cup qualification,Kuwait City,Kuwait,1971,1,12,2,-2,2,2,winner,loser,125,3,0,1,0.46848955,0.104792987
19/12/1971,19,Lebanon,Lebanon,Syria,Syria,3,2,AFC Asian Cup qualification,Kuwait City,Kuwait,1971,1,12,1,-1,1,5,winner,loser,126,3,1,0,0.7526673,0.71187889
21/12/1971,21,Kuwait,Kuwait,Jordan,Jordan,2,0,AFC Asian Cup qualification,Kuwait City,Kuwait,1971,1,12,2,-2,2,2,winner,loser,127,3,0,1,0.49309688,0.409469717
22/12/1971,22,Iraq,Iraq,Lebanon,Lebanon,4,1,AFC Asian Cup qualification,Kuwait City,Kuwait,1971,1,12,3,-3,3,5,winner,loser,128,3,0,1,0.07553587,0.858355301
24/12/1971,24,Kuwait,Kuwait,Iraq,Iraq,0,1,AFC Asian Cup qualification,Kuwait City,Kuwait,1971,1,12,-1,1,1,1,loser,winner,129,3,0,0,0.3406282,0.226418655
24/12/1971,24,Lebanon,Lebanon,Jordan,Jordan,2,0,AFC Asian Cup qualification,Kuwait City,Kuwait,1971,1,12,2,-2,2,2,winner,loser,130,3,1,1,0.27162795,0.014366366
01/01/1972,1,Algeria,Algeria,Palestine,Palestine,2,0,Friendly,Baghdad,Iraq,1972,2,1,2,-2,2,2,winner,loser,131,3,1,0,0.40028921,0.337770267
01/01/1972,1,Iraq,Iraq,Egypt,Egypt,0,0,Friendly,Baghdad,Iraq,1972,2,1,0,0,0,0,draw,draw,132,3,0,1,0.29466631,0.893787123
01/01/1972,1,Kuwait,Kuwait,Libya,Libya,3,2,Friendly,Baghdad,Iraq,1972,2,1,1,-1,1,5,winner,loser,133,3,0,0,0.19156586,0.494143379
01/01/1972,1,Syria,Syria,Yemen,Yemen,1,0,Friendly,Baghdad,Iraq,1972,2,1,1,-1,1,1,winner,loser,134,3,0,1,0.22524498,0.415199477
04/01/1972,4,Algeria,Algeria,Qatar,Qatar,3,0,Friendly,Baghdad,Iraq,1972,2,1,3,-3,3,3,winner,loser,135,3,1,1,0.11848779,0.436367461
04/01/1972,4,Palestine,Palestine,Syria,Syria,1,3,Friendly,Baghdad,Iraq,1972,2,1,-2,2,2,4,loser,winner,136,3,0,0,0.95045893,0.534609941
05/01/1972,5,Egypt,Egypt,Kuwait,Kuwait,2,0,Friendly,Baghdad,Iraq,1972,2,1,2,-2,2,2,winner,loser,137,3,1,0,0.77557888,0.628961893
05/01/1972,5,Iraq,Iraq,Libya,Libya,3,0,Friendly,Baghdad,Iraq,1972,2,1,3,-3,3,3,winner,loser,138,3,0,0,0.08141532,0.763961113
06/01/1972,6,Palestine,Palestine,Yemen,Yemen,1,2,Friendly,Baghdad,Iraq,1972,2,1,-1,1,1,3,loser,winner,139,3,0,1,0.59774022,0.558764165
06/01/1972,6,Syria,Syria,Qatar,Qatar,3,2,Friendly,Baghdad,Iraq,1972,2,1,1,-1,1,5,winner,loser,140,3,0,1,0.23436791,0.939713584
07/01/1972,7,Egypt,Egypt,Libya,Libya,1,1,Friendly,Baghdad,Iraq,1972,2,1,0,0,0,2,draw,draw,141,3,1,0,0.90074753,0.89387781
07/01/1972,7,Iraq,Iraq,Kuwait,Kuwait,3,1,Friendly,Baghdad,Iraq,1972,2,1,2,-2,2,4,winner,loser,142,3,0,0,0.20383712,0.823713493
08/01/1972,8,Algeria,Algeria,Syria,Syria,0,1,Friendly,Baghdad,Iraq,1972,2,1,-1,1,1,1,loser,winner,143,3,1,0,0.69914827,0.27629148
08/01/1972,8,Qatar,Qatar,Yemen,Yemen,1,2,Friendly,Baghdad,Iraq,1972,2,1,-1,1,1,3,loser,winner,144,3,1,1,0.3133125,0.221896958
10/01/1972,10,Algeria,Algeria,Yemen,Yemen,4,1,Friendly,Baghdad,Iraq,1972,2,1,3,-3,3,5,winner,loser,145,3,1,1,0.61444219,0.551291688
10/01/1972,10,Palestine,Palestine,Qatar,Qatar,7,2,Friendly,Baghdad,Iraq,1972,2,1,5,-5,5,9,winner,loser,146,3,0,1,0.7397965,0.236980477
12/01/1972,12,Iraq,Iraq,Algeria,Algeria,3,1,Friendly,Baghdad,Iraq,1972,2,1,2,-2,2,4,winner,loser,147,3,0,1,0.91721692,0.1324447
13/01/1972,13,Algeria,Algeria,Syria,Syria,3,1,Friendly,Baghdad,Iraq,1972,2,1,2,-2,2,4,winner,loser,148,3,1,0,0.49376468,0.181705042
27/02/1972,27,Morocco,Morocco,Sudan,Sudan,1,1,African Cup of Nations,Douala,Cameroon,1972,2,2,0,0,0,2,draw,draw,149,3,0,1,0.30231527,0.139277638
21/03/1974,21,Bahrain,Bahrain,Saudi Arabia,Saudi_Arabia,1,4,Gulf Cup,Kuwait City,Kuwait,1974,4,3,-3,3,3,5,loser,winner,201,3,0,0,0.403139,0.841648603
26/03/1974,26,Qatar,Qatar,Saudi Arabia,Saudi_Arabia,1,3,Gulf Cup,Kuwait City,Kuwait,1974,4,3,-2,2,2,4,loser,winner,206,3,1,0,0.37176324,0.456270047
18/03/1972,18,Bahrain,Bahrain,Kuwait,Kuwait,0,2,Gulf Cup,Riyadh,Saudi Arabia,1972,2,3,-2,2,2,2,loser,winner,152,3,0,0,0.84863229,0.147249867
24/03/1972,24,Saudi Arabia,Saudi_Arabia,Qatar,Qatar,4,0,Gulf Cup,Riyadh,Saudi Arabia,1972,2,3,4,-4,4,4,winner,loser,156,3,0,1,0.37855676,0.802403023
21/03/1972,21,Bahrain,Bahrain,Qatar,Qatar,6,2,Gulf Cup,Riyadh,Saudi Arabia,1972,2,3,4,-4,4,8,winner,loser,154,3,0,1,0.8712321,0.304196242
29/03/1974,29,Kuwait,Kuwait,Saudi Arabia,Saudi_Arabia,4,0,Gulf Cup,Kuwait City,Kuwait,1974,4,3,4,-4,4,4,winner,loser,208,3,0,0,0.15457002,0.111875623
28/03/1972,28,Saudi Arabia,Saudi_Arabia,Bahrain,Bahrain,2,1,Gulf Cup,Riyadh,Saudi Arabia,1972,2,3,1,-1,1,3,winner,loser,159,3,0,0,0.5716924,0.835912018
06/04/1975,6,Iraq,Iraq,Saudi Arabia,Saudi_Arabia,1,1,AFC Asian Cup qualification,Baghdad,Iraq,1975,5,4,0,0,0,2,draw,draw,242,3,0,0,0.47765471,0.816390746
26/03/1972,26,Kuwait,Kuwait,Qatar,Qatar,5,0,Gulf Cup,Riyadh,Saudi Arabia,1972,2,3,5,-5,5,5,winner,loser,158,3,0,1,0.01869936,0.545335744
06/03/1974,6,Saudi Arabia,Saudi_Arabia,Morocco,Morocco,0,0,Friendly,Riyadh,Saudi Arabia,1974,4,3,0,0,0,0,draw,draw,195,3,0,0,0.07887164,0.180755583
05/06/1972,5,Tunisia,Tunisia,Algeria,Algeria,3,1,Friendly,Tunis,Tunisia,1972,2,6,2,-2,2,4,winner,loser,160,3,1,1,0.31109481,0.958423112
16/11/1972,16,Tunisia,Tunisia,Algeria,Algeria,1,2,Friendly,Tunis,Tunisia,1972,2,11,-1,1,1,3,loser,winner,161,3,1,1,0.67960505,0.937000752
08/12/1972,8,Egypt,Egypt,Tunisia,Tunisia,2,1,FIFA World Cup qualification,Cairo,Egypt,1972,2,12,1,-1,1,3,winner,loser,162,3,1,1,0.61528557,0.667428813
17/12/1972,17,Tunisia,Tunisia,Egypt,Egypt,2,0,FIFA World Cup qualification,Tunis,Tunisia,1972,2,12,2,-2,2,2,winner,loser,163,3,1,1,0.54346582,0.639328474
12/04/1973,12,Kuwait,Kuwait,Qatar,Qatar,9,0,Friendly,Kuwait City,Kuwait,1973,3,4,9,-9,9,9,winner,loser,164,3,0,1,0.71320554,0.766476565
17/04/1973,17,Kuwait,Kuwait,Qatar,Qatar,4,1,Friendly,Kuwait City,Kuwait,1973,3,4,3,-3,3,5,winner,loser,165,3,0,1,0.14776018,0.391772185
04/05/1973,4,Syria,Syria,Kuwait,Kuwait,2,1,FIFA World Cup qualification,Teheran,Iran,1973,3,5,1,-1,1,3,winner,loser,166,3,0,0,0.18300463,0.484905993
11/05/1973,11,Syria,Syria,Kuwait,Kuwait,2,0,FIFA World Cup qualification,Teheran,Iran,1973,3,5,2,-2,2,2,winner,loser,167,3,0,0,0.57105905,0.405265239
12/04/1975,12,Iraq,Iraq,Saudi Arabia,Saudi_Arabia,2,1,AFC Asian Cup qualification,Baghdad,Iraq,1975,5,4,1,-1,1,3,winner,loser,244,3,0,0,0.33208957,0.923026943
12/08/1973,12,Egypt,Egypt,Yemen,Yemen,6,1,Friendly,Tripoli,Libya,1973,3,8,5,-5,5,7,winner,loser,169,3,1,1,0.42774909,0.487856908
23/12/1975,23,Egypt,Egypt,Saudi Arabia,Saudi_Arabia,2,1,Friendly,Tunis,Tunisia,1975,5,12,1,-1,1,3,winner,loser,254,3,1,0,0.14346506,0.67037873
13/08/1973,13,Iraq,Iraq,Yemen,Yemen,2,0,Friendly,Benghazi,Libya,1973,3,8,2,-2,2,2,winner,loser,171,3,0,1,0.97952596,0.45841418
13/08/1973,13,Syria,Syria,Tunisia,Tunisia,1,4,Friendly,Tripoli,Libya,1973,3,8,-3,3,3,5,loser,winner,172,3,0,1,0.9861797,0.29838381
14/08/1973,14,Libya,Libya,Yemen,Yemen,10,0,Friendly,Benghazi,Libya,1973,3,8,10,-10,10,10,winner,loser,173,3,0,1,0.87361714,0.397934
15/08/1973,15,Algeria,Algeria,Iraq,Iraq,0,0,Friendly,Benghazi,Libya,1973,3,8,0,0,0,0,draw,draw,174,3,1,0,0.83066272,0.441545239
15/08/1973,15,Egypt,Egypt,Tunisia,Tunisia,0,1,Friendly,Tripoli,Libya,1973,3,8,-1,1,1,1,loser,winner,175,3,1,1,0.08703667,0.562733911
16/08/1973,16,Syria,Syria,Yemen,Yemen,7,1,Friendly,Tripoli,Libya,1973,3,8,6,-6,6,8,winner,loser,176,3,0,1,0.27395998,0.246979526
17/08/1973,17,Algeria,Algeria,Yemen,Yemen,15,1,Friendly,Benghazi,Libya,1973,3,8,14,-14,14,16,winner,loser,177,3,1,1,0.98618255,0.693045032
18/08/1973,18,Egypt,Egypt,Palestine,Palestine,2,0,Friendly,Tripoli,Libya,1973,3,8,2,-2,2,2,winner,loser,178,3,1,0,0.42925007,0.398064021
18/08/1973,18,Libya,Libya,Iraq,Iraq,0,0,Friendly,Benghazi,Libya,1973,3,8,0,0,0,0,draw,draw,179,3,0,0,0.66274721,0.082803724
19/08/1973,19,Tunisia,Tunisia,Yemen,Yemen,2,0,Friendly,Tripoli,Libya,1973,3,8,2,-2,2,2,winner,loser,180,3,1,1,0.96318142,0.377599298
20/08/1973,20,Egypt,Egypt,Syria,Syria,0,2,Friendly,Tripoli,Libya,1973,3,8,-2,2,2,2,loser,winner,181,3,1,0,0.26400659,0.650163583
26/03/1976,26,Qatar,Qatar,Saudi Arabia,Saudi_Arabia,1,0,Gulf Cup,Doha,Qatar,1976,6,3,1,-1,1,1,winner,loser,266,3,1,0,0.67895087,0.552727704
21/08/1973,21,Libya,Libya,Algeria,Algeria,0,2,Friendly,Benghazi,Libya,1973,3,8,-2,2,2,2,loser,winner,183,3,0,1,0.46582573,0.083170268
21/08/1973,21,Palestine,Palestine,Tunisia,Tunisia,2,6,Friendly,Tripoli,Libya,1973,3,8,-4,4,4,8,loser,winner,184,3,0,1,0.78893273,0.735650257
23/08/1973,23,Algeria,Algeria,Syria,Syria,0,0,Friendly,Benghazi,Libya,1973,3,8,0,0,0,0,draw,draw,185,3,1,0,0.48440213,0.369789978
23/08/1973,23,Iraq,Iraq,Tunisia,Tunisia,0,2,Friendly,Tripoli,Libya,1973,3,8,-2,2,2,2,loser,winner,186,3,0,1,0.32236557,0.008113535
25/08/1973,25,Algeria,Algeria,Iraq,Iraq,0,0,Friendly,Tripoli,Libya,1973,3,8,0,0,0,0,draw,draw,187,3,1,0,0.27025153,0.018187962
26/08/1973,26,Syria,Syria,Tunisia,Tunisia,0,4,Friendly,Tripoli,Libya,1973,3,8,-4,4,4,4,loser,winner,188,3,0,1,0.12641693,0.62448262
31/10/1973,31,Algeria,Algeria,Morocco,Morocco,2,0,Friendly,Algiers,Algeria,1973,3,10,2,-2,2,2,winner,loser,189,3,1,0,0.48947483,0.366132237
22/02/1974,22,Iraq,Iraq,Morocco,Morocco,0,0,Friendly,Baghdad,Iraq,1974,4,2,0,0,0,0,draw,draw,190,3,0,0,0.4629455,0.774750526
24/02/1974,24,Iraq,Iraq,Morocco,Morocco,0,0,Friendly,Baghdad,Iraq,1974,4,2,0,0,0,0,draw,draw,191,3,0,0,0.06318522,0.39785181
25/02/1974,25,Kuwait,Kuwait,Morocco,Morocco,0,2,Friendly,Kuwait City,Kuwait,1974,4,2,-2,2,2,2,loser,winner,192,3,0,0,0.85397948,0.407914872
27/02/1974,27,Qatar,Qatar,Morocco,Morocco,0,1,Friendly,Doha,Qatar,1974,4,2,-1,1,1,1,loser,winner,193,3,1,0,0.18581186,0.276831763
01/03/1974,1,Bahrain,Bahrain,Morocco,Morocco,0,1,Friendly,Manama,Bahrain,1974,4,3,-1,1,1,1,loser,winner,194,3,0,0,0.65742299,0.299091764
01/04/1976,1,Iraq,Iraq,Saudi Arabia,Saudi_Arabia,7,1,Gulf Cup,Doha,Qatar,1976,6,4,6,-6,6,8,winner,loser,274,3,0,0,0.31233177,0.640954098
04/04/1976,4,Oman,Oman,Saudi Arabia,Saudi_Arabia,1,3,Gulf Cup,Doha,Qatar,1976,6,4,-2,2,2,4,loser,winner,279,3,1,0,0.10091568,0.749331703
16/03/1974,16,Bahrain,Bahrain,Oman,Oman,4,0,Gulf Cup,Kuwait City,Kuwait,1974,4,3,4,-4,4,4,winner,loser,197,3,0,1,0.33814786,0.910170268
08/04/1976,8,Bahrain,Bahrain,Saudi Arabia,Saudi_Arabia,2,1,Gulf Cup,Doha,Qatar,1976,6,4,1,-1,1,3,winner,loser,283,3,0,0,0.30732745,0.1727639
11/04/1976,11,Kuwait,Kuwait,Saudi Arabia,Saudi_Arabia,3,1,Gulf Cup,Doha,Qatar,1976,6,4,2,-2,2,4,winner,loser,287,3,0,0,0.71924981,0.473824088
19/03/1974,19,Kuwait,Kuwait,Oman,Oman,5,0,Gulf Cup,Kuwait City,Kuwait,1974,4,3,5,-5,5,5,winner,loser,200,3,0,1,0.18430647,0.17492416
26/11/1976,26,Syria,Syria,Saudi Arabia,Saudi_Arabia,2,1,FIFA World Cup qualification,Damascus,Syria,1976,6,11,1,-1,1,3,winner,loser,302,3,0,0,0.03769535,0.652912011
22/03/1974,22,Oman,Oman,Qatar,Qatar,0,4,Gulf Cup,Kuwait City,Kuwait,1974,4,3,-4,4,4,4,loser,winner,202,3,1,1,0.81695718,0.763863552
04/04/1975,4,Saudi Arabia,Saudi_Arabia,Qatar,Qatar,2,1,AFC Asian Cup qualification,Baghdad,Iraq,1975,5,4,1,-1,1,3,winner,loser,240,3,0,1,0.9746964,0.426539618
24/03/1974,24,Kuwait,Kuwait,Qatar,Qatar,1,0,Gulf Cup,Kuwait City,Kuwait,1974,4,3,1,-1,1,1,winner,loser,204,3,0,1,0.64810299,0.974447297
06/04/1979,6,Kuwait,Kuwait,Saudi Arabia,Saudi_Arabia,0,0,Gulf Cup,Baghdad,Iraq,1979,9,4,0,0,0,0,draw,draw,347,3,0,0,0.46306569,0.11443272
08/04/1979,8,Iraq,Iraq,Saudi Arabia,Saudi_Arabia,2,0,Gulf Cup,Baghdad,Iraq,1979,9,4,2,-2,2,2,winner,loser,349,3,0,0,0.53436153,0.712351896
04/10/1980,4,Libya,Libya,Saudi Arabia,Saudi_Arabia,2,0,Friendly,Izmir,Turkey,1980,0,10,2,-2,2,2,winner,loser,361,4,0,0,0.15705325,0.649668971
07/12/1981,7,Kuwait,Kuwait,Saudi Arabia,Saudi_Arabia,2,0,FIFA World Cup qualification,Kuwait City,Kuwait,1981,1,12,2,-2,2,2,winner,loser,390,4,0,0,0.35991135,0.57402938
07/04/1974,7,Morocco,Morocco,Algeria,Algeria,2,0,Friendly,Casablanca,Morocco,1974,4,4,2,-2,2,2,winner,loser,209,3,0,1,0.24988828,0.833118864
02/05/1974,2,Yemen,Yemen,Iraq,Iraq,2,0,Friendly,Aden,Yemen DPR,1974,4,5,2,-2,2,2,winner,loser,210,3,1,0,0.737655,0.332287138
02/06/1974,2,Tunisia,Tunisia,Iraq,Iraq,2,1,Friendly,Tunis,Tunisia,1974,4,6,1,-1,1,3,winner,loser,211,3,1,0,0.63702509,0.926460924
07/06/1974,7,Libya,Libya,Iraq,Iraq,1,0,Friendly,Tripoli,Libya,1974,4,6,1,-1,1,1,winner,loser,212,3,0,0,0.21635569,0.311892719
14/08/1974,14,Iraq,Iraq,Bahrain,Bahrain,4,0,Friendly,Baghdad,Iraq,1974,4,8,4,-4,4,4,winner,loser,213,3,0,0,0.44277853,0.122159421
10/09/1974,10,Libya,Libya,Somalia,Somalia,3,2,Friendly,Tripoli,Libya,1974,4,9,1,-1,1,5,winner,loser,214,3,0,1,0.80627847,0.247564696
13/09/1974,13,Libya,Libya,Somalia,Somalia,3,2,Friendly,Tripoli,Libya,1974,4,9,1,-1,1,5,winner,loser,215,3,0,1,0.00040179,0.395829334
26/09/1974,26,Syria,Syria,Palestine,Palestine,2,0,Friendly,Damascus,Syria,1974,4,9,2,-2,2,2,winner,loser,216,3,0,0,0.40839862,0.229058086
27/09/1974,27,Algeria,Algeria,Lebanon,Lebanon,4,1,Friendly,Damascus,Syria,1974,4,9,3,-3,3,5,winner,loser,217,3,1,1,0.12466858,0.358384219
28/09/1974,28,Yemen,Yemen,Sudan,Sudan,0,6,Friendly,Damascus,Syria,1974,4,9,-6,6,6,6,loser,winner,218,3,1,1,0.87026867,0.873854873
29/09/1974,29,Algeria,Algeria,Jordan,Jordan,6,0,Friendly,Damascus,Syria,1974,4,9,6,-6,6,6,winner,loser,219,3,1,1,0.04022751,0.310808146
30/09/1974,30,Libya,Libya,Yemen,Yemen,9,1,Friendly,Damascus,Syria,1974,4,9,8,-8,8,10,winner,loser,220,3,0,1,0.73572225,0.93299171
30/09/1974,30,Palestine,Palestine,Sudan,Sudan,1,3,Friendly,Damascus,Syria,1974,4,9,-2,2,2,4,loser,winner,221,3,0,1,0.53994846,0.738617426
01/10/1974,1,Morocco,Morocco,Tunisia,Tunisia,3,1,Friendly,Damascus,Syria,1974,4,10,2,-2,2,4,winner,loser,222,3,0,1,0.26907125,0.201781697
02/10/1974,2,Libya,Libya,Palestine,Palestine,0,0,Friendly,Damascus,Syria,1974,4,10,0,0,0,0,draw,draw,223,3,0,0,0.41616125,0.150373369
03/10/1974,3,Algeria,Algeria,Tunisia,Tunisia,0,1,Friendly,Damascus,Syria,1974,4,10,-1,1,1,1,loser,winner,224,3,1,1,0.03387491,0.568532555
04/10/1974,4,Libya,Libya,Sudan,Sudan,1,3,Friendly,Damascus,Syria,1974,4,10,-2,2,2,4,loser,winner,225,3,0,1,0.9081964,0.269055323
04/10/1974,4,Syria,Syria,Yemen,Yemen,6,0,Friendly,Damascus,Syria,1974,4,10,6,-6,6,6,winner,loser,226,3,0,1,0.86056228,0.106075139
06/10/1974,6,Palestine,Palestine,Yemen,Yemen,7,1,Friendly,Damascus,Syria,1974,4,10,6,-6,6,8,winner,loser,227,3,0,1,0.58745925,0.250455183
07/10/1974,7,Morocco,Morocco,Sudan,Sudan,2,0,Friendly,Damascus,Syria,1974,4,10,2,-2,2,2,winner,loser,228,3,0,1,0.71556156,0.014274498
09/10/1974,9,Sudan,Sudan,Tunisia,Tunisia,1,3,Friendly,Damascus,Syria,1974,4,10,-2,2,2,4,loser,winner,229,3,1,1,0.87724406,0.345773142
09/10/1974,9,Syria,Syria,Morocco,Morocco,1,1,Friendly,Damascus,Syria,1974,4,10,0,0,0,2,draw,draw,230,3,0,0,0.33042327,0.872460922
31/10/1974,31,Algeria,Algeria,Morocco,Morocco,0,0,Friendly,Algiers,Algeria,1974,4,10,0,0,0,0,draw,draw,231,3,1,0,0.77401147,0.866579742
10/11/1974,10,Tunisia,Tunisia,Libya,Libya,1,0,African Cup of Nations qualification,Tunis,Tunisia,1974,4,11,1,-1,1,1,winner,loser,232,3,1,0,0.95944728,0.098052154
22/11/1974,22,Libya,Libya,Tunisia,Tunisia,1,0,African Cup of Nations qualification,Tripoli,Libya,1974,4,11,1,-1,1,1,winner,loser,233,3,0,1,0.13272788,0.715792602
29/12/1974,29,Kuwait,Kuwait,Tunisia,Tunisia,2,0,Friendly,Kuwait City,Kuwait,1974,4,12,2,-2,2,2,winner,loser,234,3,0,1,0.18984405,0.255645595
01/01/1975,1,Iraq,Iraq,Tunisia,Tunisia,0,0,Friendly,Baghdad,Iraq,1975,5,1,0,0,0,0,draw,draw,235,3,0,1,0.4614075,0.838155051
09/01/1975,9,Iraq,Iraq,Libya,Libya,3,1,Friendly,Baghdad,Iraq,1975,5,1,2,-2,2,4,winner,loser,236,3,0,0,0.14715179,0.587262763
14/01/1975,14,Kuwait,Kuwait,Libya,Libya,1,0,Friendly,Kuwait City,Kuwait,1975,5,1,1,-1,1,1,winner,loser,237,3,0,0,0.69203706,0.739195543
02/03/1975,2,Morocco,Morocco,Tunisia,Tunisia,0,0,Friendly,Casablanca,Morocco,1975,5,3,0,0,0,0,draw,draw,238,3,0,1,0.44550088,0.507599387
02/04/1975,2,Iraq,Iraq,Qatar,Qatar,1,0,AFC Asian Cup qualification,Baghdad,Iraq,1975,5,4,1,-1,1,1,winner,loser,239,3,0,1,0.39562356,0.647790514
14/04/1975,14,Saudi Arabia,Saudi_Arabia,Qatar,Qatar,0,1,AFC Asian Cup qualification,Baghdad,Iraq,1975,5,4,-1,1,1,1,loser,winner,245,3,0,1,0.70402444,0.674329368
06/04/1975,6,Algeria,Algeria,Tunisia,Tunisia,1,2,African Cup of Nations qualification,Oran,Algeria,1975,5,4,-1,1,1,3,loser,winner,241,3,1,1,0.8930215,0.878655534
02/04/1982,2,Bahrain,Bahrain,Saudi Arabia,Saudi_Arabia,2,2,Gulf Cup,Abu Dhabi,United Arab Emirates,1982,2,4,0,0,0,4,draw,draw,407,4,0,0,0.27735935,0.74435922
10/04/1975,10,Iraq,Iraq,Qatar,Qatar,3,0,AFC Asian Cup qualification,Baghdad,Iraq,1975,5,4,3,-3,3,3,winner,loser,243,3,0,1,0.43372227,0.753809383
15/03/1984,15,Oman,Oman,Saudi Arabia,Saudi_Arabia,1,3,Gulf Cup,Muscat,Oman,1984,4,3,-2,2,2,4,loser,winner,428,4,1,0,0.39386515,0.874394688
21/12/1975,21,Saudi Arabia,Saudi_Arabia,Yemen,Yemen,0,1,Friendly,Tunis,Tunisia,1975,5,12,-1,1,1,1,loser,winner,253,3,0,1,0.57651868,0.40047892
06/07/1975,6,Tunisia,Tunisia,Sudan,Sudan,3,2,African Cup of Nations qualification,Tunis,Tunisia,1975,5,7,1,-1,1,5,winner,loser,246,3,1,1,0.39746166,0.832512049
19/12/1975,19,Egypt,Egypt,Yemen,Yemen,5,0,Friendly,Tunis,Tunisia,1975,5,12,5,-5,5,5,winner,loser,247,3,1,1,0.94176652,0.695804793
19/12/1975,19,Palestine,Palestine,Sudan,Sudan,0,0,Friendly,Tunis,Tunisia,1975,5,12,0,0,0,0,draw,draw,248,3,0,1,0.8857281,0.472933072
17/03/1984,17,Iraq,Iraq,Saudi Arabia,Saudi_Arabia,4,0,Gulf Cup,Muscat,Oman,1984,4,3,4,-4,4,4,winner,loser,431,4,0,0,0.27030503,0.83274309
26/03/1984,26,Bahrain,Bahrain,Saudi Arabia,Saudi_Arabia,0,2,Gulf Cup,Muscat,Oman,1984,4,3,-2,2,2,2,loser,winner,442,4,0,0,0.47158236,0.199365418
21/12/1975,21,Libya,Libya,Syria,Syria,2,3,Friendly,Tunis,Tunisia,1975,5,12,-1,1,1,5,loser,winner,251,3,0,0,0.28926531,0.862790962
21/12/1975,21,Palestine,Palestine,Sudan,Sudan,0,1,Friendly,Tunis,Tunisia,1975,5,12,-1,1,1,1,loser,winner,252,3,0,1,0.53747797,0.230820268
09/01/1976,9,Saudi Arabia,Saudi_Arabia,Algeria,Algeria,1,3,Friendly,Riyadh,Saudi Arabia,1976,6,1,-2,2,2,4,loser,winner,262,3,0,1,0.31661462,0.886439559
04/12/1984,4,Syria,Syria,Saudi Arabia,Saudi_Arabia,0,1,AFC Asian Cup,Kallang,Singapore,1984,4,12,-1,1,1,1,loser,winner,451,4,0,0,0.67928485,0.325485143
23/12/1975,23,Libya,Libya,Syria,Syria,1,0,Friendly,Tunis,Tunisia,1975,5,12,1,-1,1,1,winner,loser,255,3,0,0,0.24933217,0.723824259
23/12/1975,23,Tunisia,Tunisia,Iraq,Iraq,1,1,Friendly,Tunis,Tunisia,1975,5,12,0,0,0,2,draw,draw,256,3,1,0,0.22278039,0.329143134
26/12/1975,26,Egypt,Egypt,Sudan,Sudan,3,1,Friendly,Tunis,Tunisia,1975,5,12,2,-2,2,4,winner,loser,257,3,1,1,0.15650779,0.020952218
26/12/1975,26,Iraq,Iraq,Syria,Syria,4,0,Friendly,Tunis,Tunisia,1975,5,12,4,-4,4,4,winner,loser,258,3,0,0,0.94913952,0.746068059
28/12/1975,28,Egypt,Egypt,Iraq,Iraq,1,0,Friendly,Tunis,Tunisia,1975,5,12,1,-1,1,1,winner,loser,259,3,1,0,0.71818764,0.871738874
28/12/1975,28,Sudan,Sudan,Syria,Syria,1,0,Friendly,Tunis,Tunisia,1975,5,12,1,-1,1,1,winner,loser,260,3,1,0,0.19950291,0.101516448
01/01/1976,1,Libya,Libya,Sudan,Sudan,1,0,Friendly,Tripoli,Libya,1976,6,1,1,-1,1,1,winner,loser,261,3,0,1,0.95702159,0.641537746
20/02/1976,20,Saudi Arabia,Saudi_Arabia,Morocco,Morocco,0,2,Friendly,Riyadh,Saudi Arabia,1976,6,2,-2,2,2,2,loser,winner,263,3,0,0,0.02554259,0.330001658
08/12/1984,8,Qatar,Qatar,Saudi Arabia,Saudi_Arabia,1,1,AFC Asian Cup,Kallang,Singapore,1984,4,12,0,0,0,2,draw,draw,452,4,1,0,0.27616015,0.919846289
01/03/1976,1,Morocco,Morocco,Sudan,Sudan,2,2,African Cup of Nations,Dire Dawa,Ethiopia,1976,6,3,0,0,0,4,draw,draw,264,3,0,1,0.56334018,0.466917422
09/03/1976,9,Egypt,Egypt,Morocco,Morocco,1,2,African Cup of Nations,Addis Abeba,Ethiopia,1976,6,3,-1,1,1,3,loser,winner,265,3,1,0,0.33070113,0.412878396
28/07/1985,28,Tunisia,Tunisia,Saudi Arabia,Saudi_Arabia,1,0,Friendly,Tunis,Tunisia,1985,5,7,1,-1,1,1,winner,loser,499,4,1,0,0.43598761,0.194766896
25/03/1986,25,Bahrain,Bahrain,Saudi Arabia,Saudi_Arabia,2,1,Gulf Cup,Riffa,Bahrain,1986,6,3,1,-1,1,3,winner,loser,520,4,0,0,0.16741146,0.437562769
27/03/1976,27,Iraq,Iraq,Oman,Oman,4,0,Gulf Cup,Doha,Qatar,1976,6,3,4,-4,4,4,winner,loser,268,3,0,1,0.78423728,0.942539221
28/03/1976,28,Qatar,Qatar,Kuwait,Kuwait,0,4,Gulf Cup,Doha,Qatar,1976,6,3,-4,4,4,4,loser,winner,269,3,1,0,0.77674978,0.702651266
29/03/1976,29,Bahrain,Bahrain,Iraq,Iraq,1,4,Gulf Cup,Doha,Qatar,1976,6,3,-3,3,3,5,loser,winner,270,3,0,0,0.85504411,0.117953353
05/09/1976,5,Saudi Arabia,Saudi_Arabia,Iraq,Iraq,0,0,Friendly,Riyadh,Saudi Arabia,1976,6,9,0,0,0,0,draw,draw,292,3,0,0,0.3235765,0.343050684
31/03/1976,31,Kuwait,Kuwait,Oman,Oman,8,0,Gulf Cup,Doha,Qatar,1976,6,3,8,-8,8,8,winner,loser,272,3,0,1,0.7168875,0.685635318
01/04/1976,1,Algeria,Algeria,Libya,Libya,1,0,FIFA World Cup qualification,Algiers,Algeria,1976,6,4,1,-1,1,1,winner,loser,273,3,1,0,0.3780642,0.856099355
30/03/1986,30,Iraq,Iraq,Saudi Arabia,Saudi_Arabia,1,2,Gulf Cup,Riffa,Bahrain,1986,6,3,-1,1,1,3,loser,winner,526,4,0,0,0.05807063,0.898332169
05/04/1986,5,Qatar,Qatar,Saudi Arabia,Saudi_Arabia,0,2,Gulf Cup,Riffa,Bahrain,1986,6,4,-2,2,2,2,loser,winner,533,4,1,0,0.72144044,0.940882694
02/04/1976,2,Bahrain,Bahrain,Oman,Oman,1,0,Gulf Cup,Doha,Qatar,1976,6,4,1,-1,1,1,winner,loser,276,3,0,1,0.60678225,0.78954957
09/07/1988,9,Egypt,Egypt,Saudi Arabia,Saudi_Arabia,0,0,UAFA Cup,Amman,Jordan,1988,8,7,0,0,0,0,draw,draw,586,4,1,0,0.19522879,0.627597678
03/04/1976,3,Qatar,Qatar,Iraq,Iraq,0,0,Gulf Cup,Doha,Qatar,1976,6,4,0,0,0,0,draw,draw,278,3,1,0,0.13598935,0.596094515
13/07/1988,13,Lebanon,Lebanon,Saudi Arabia,Saudi_Arabia,1,0,UAFA Cup,Amman,Jordan,1988,8,7,1,-1,1,1,winner,loser,595,4,1,0,0.41900704,0.399052424
06/04/1976,6,Bahrain,Bahrain,Kuwait,Kuwait,2,5,Gulf Cup,Doha,Qatar,1976,6,4,-3,3,3,7,loser,winner,280,3,0,0,0.2217877,0.212317753
15/07/1988,15,Iraq,Iraq,Saudi Arabia,Saudi_Arabia,2,0,UAFA Cup,Amman,Jordan,1988,8,7,2,-2,2,2,winner,loser,599,4,0,0,0.3318525,0.07274955
07/04/1976,7,Qatar,Qatar,Oman,Oman,4,1,Gulf Cup,Doha,Qatar,1976,6,4,3,-3,3,5,winner,loser,282,3,1,1,0.72271659,0.882307149
02/12/1988,2,Syria,Syria,Saudi Arabia,Saudi_Arabia,0,2,AFC Asian Cup,Doha,Qatar,1988,8,12,-2,2,2,2,loser,winner,614,4,0,0,0.50297475,0.573305117
08/04/1976,8,Iraq,Iraq,Kuwait,Kuwait,2,2,Gulf Cup,Doha,Qatar,1976,6,4,0,0,0,4,draw,draw,284,3,0,0,0.56859157,0.322505831
20/03/1989,20,Yemen,Yemen,Saudi Arabia,Saudi_Arabia,0,1,FIFA World Cup qualification,Sana'a,Yemen AR,1989,9,3,-1,1,1,1,loser,winner,640,4,1,0,0.54475395,0.950179422
10/04/1976,10,Qatar,Qatar,Bahrain,Bahrain,3,0,Gulf Cup,Doha,Qatar,1976,6,4,3,-3,3,3,winner,loser,286,3,1,0,0.5276466,0.308941521
30/03/1989,30,Syria,Syria,Saudi Arabia,Saudi_Arabia,0,0,FIFA World Cup qualification,Latakia,Syria,1989,9,3,0,0,0,0,draw,draw,643,4,0,0,0.41141256,0.739361686
15/04/1976,15,Iraq,Iraq,Kuwait,Kuwait,2,4,Gulf Cup,Doha,Qatar,1976,6,4,-2,2,2,6,loser,winner,288,3,0,0,0.72395186,0.479761735
16/04/1976,16,Libya,Libya,Algeria,Algeria,0,0,FIFA World Cup qualification,Tripoli,Libya,1976,6,4,0,0,0,0,draw,draw,289,3,0,1,0.01114058,0.897228727
06/06/1976,6,Iraq,Iraq,Yemen,Yemen,1,0,AFC Asian Cup,Teheran,Iran,1976,6,6,1,-1,1,1,winner,loser,290,3,0,1,0.66811576,0.000615917
10/06/1976,10,Iraq,Iraq,Kuwait,Kuwait,2,3,AFC Asian Cup,Teheran,Iran,1976,6,6,-1,1,1,5,loser,winner,291,3,0,0,0.00272679,0.948155597
12/09/1976,12,Saudi Arabia,Saudi_Arabia,Morocco,Morocco,0,2,Friendly,Riyadh,Saudi Arabia,1976,6,9,-2,2,2,2,loser,winner,295,3,0,0,0.82287349,0.532369664
08/09/1976,8,Libya,Libya,Algeria,Algeria,0,1,Friendly,Benghazi,Libya,1976,6,9,-1,1,1,1,loser,winner,293,3,0,1,0.81682121,0.951358551
10/09/1976,10,Libya,Libya,Algeria,Algeria,1,0,Friendly,Tripoli,Libya,1976,6,9,1,-1,1,1,winner,loser,294,3,0,1,0.81504165,0.275680846
30/09/1976,30,Saudi Arabia,Saudi_Arabia,Tunisia,Tunisia,0,1,Friendly,Dammam,Saudi Arabia,1976,6,9,-1,1,1,1,loser,winner,296,3,0,1,0.8642581,0.421265702
12/11/1976,12,Saudi Arabia,Saudi_Arabia,Syria,Syria,2,0,FIFA World Cup qualification,Jeddah,Saudi Arabia,1976,6,11,2,-2,2,2,winner,loser,301,3,0,0,0.18758258,0.287365717
20/10/1976,20,Iraq,Iraq,Libya,Libya,1,0,Friendly,Baghdad,Iraq,1976,6,10,1,-1,1,1,winner,loser,297,3,0,0,0.69502252,0.273815883
22/10/1976,22,Iraq,Iraq,Libya,Libya,3,1,Friendly,Baghdad,Iraq,1976,6,10,2,-2,2,4,winner,loser,298,3,0,0,0.4321694,0.18157691
01/11/1976,1,Algeria,Algeria,Libya,Libya,2,0,Friendly,Algiers,Algeria,1976,6,11,2,-2,2,2,winner,loser,299,3,1,0,0.69510404,0.30458239
04/11/1976,4,Tunisia,Tunisia,Libya,Libya,3,0,Friendly,Tunis,Tunisia,1976,6,11,3,-3,3,3,winner,loser,300,3,1,0,0.99923771,0.831003391
16/10/1989,16,Qatar,Qatar,Saudi Arabia,Saudi_Arabia,1,1,FIFA World Cup qualification,Singapore,Singapore,1989,9,10,0,0,0,2,draw,draw,653,4,1,0,0.87206761,0.716343309
04/12/1992,4,Oman,Oman,Saudi Arabia,Saudi_Arabia,0,2,Gulf Cup,Doha,Qatar,1992,2,12,-2,2,2,2,loser,winner,710,5,1,0,0.81372764,0.691651436
12/12/1976,12,Morocco,Morocco,Tunisia,Tunisia,1,1,FIFA World Cup qualification,Casablanca,Morocco,1976,6,12,0,0,0,2,draw,draw,303,3,0,1,0.33589528,0.846662693
09/01/1977,9,Tunisia,Tunisia,Morocco,Morocco,1,1,FIFA World Cup qualification,Tunis,Tunisia,1977,7,1,0,0,0,2,draw,draw,304,3,1,0,0.29042968,0.352021768
06/02/1977,6,Tunisia,Tunisia,Algeria,Algeria,2,0,FIFA World Cup qualification,Tunis,Tunisia,1977,7,2,2,-2,2,2,winner,loser,305,3,1,1,0.36243415,0.93580246
28/02/1977,28,Algeria,Algeria,Tunisia,Tunisia,1,1,FIFA World Cup qualification,Algiers,Algeria,1977,7,2,0,0,0,2,draw,draw,306,3,1,1,0.03224186,0.492948662
08/03/1977,8,Qatar,Qatar,Tunisia,Tunisia,1,0,Friendly,Doha,Qatar,1977,7,3,1,-1,1,1,winner,loser,307,3,1,1,0.51810749,0.686477875
11/03/1977,11,Bahrain,Bahrain,Kuwait,Kuwait,0,2,FIFA World Cup qualification,Doha,Qatar,1977,7,3,-2,2,2,2,loser,winner,308,3,0,0,0.395743,0.323180558
13/03/1977,13,Qatar,Qatar,Bahrain,Bahrain,2,0,FIFA World Cup qualification,Doha,Qatar,1977,7,3,2,-2,2,2,winner,loser,309,3,1,0,0.93018727,0.713732022
15/03/1977,15,Qatar,Qatar,Kuwait,Kuwait,0,2,FIFA World Cup qualification,Doha,Qatar,1977,7,3,-2,2,2,2,loser,winner,310,3,1,0,0.81561029,0.806840378
17/03/1977,17,Bahrain,Bahrain,Kuwait,Kuwait,1,2,FIFA World Cup qualification,Doha,Qatar,1977,7,3,-1,1,1,3,loser,winner,311,3,0,0,0.58151587,0.060497968
19/03/1977,19,Qatar,Qatar,Bahrain,Bahrain,0,3,FIFA World Cup qualification,Doha,Qatar,1977,7,3,-3,3,3,3,loser,winner,312,3,1,0,0.91883794,0.749809064
21/03/1977,21,Qatar,Qatar,Kuwait,Kuwait,1,4,FIFA World Cup qualification,Doha,Qatar,1977,7,3,-3,3,3,5,loser,winner,313,3,1,0,0.35386992,0.472001685
23/03/1977,23,Syria,Syria,Morocco,Morocco,0,2,Friendly,Damascus,Syria,1977,7,3,-2,2,2,2,loser,winner,314,3,0,0,0.12367152,0.924749972
19/07/1977,19,Iraq,Iraq,Libya,Libya,0,0,Merdeka Tournament,Kuala Lumpur,Malaysia,1977,7,7,0,0,0,0,draw,draw,315,3,0,0,0.57610539,0.887280507
25/11/1977,25,Egypt,Egypt,Tunisia,Tunisia,3,2,FIFA World Cup qualification,Cairo,Egypt,1977,7,11,1,-1,1,5,winner,loser,316,3,1,1,0.81798011,0.808879131
27/11/1977,27,Iraq,Iraq,Morocco,Morocco,3,0,Friendly,Baghdad,Iraq,1977,7,11,3,-3,3,3,winner,loser,317,3,0,0,0.93497246,0.140725098
03/12/1977,3,Morocco,Morocco,Iraq,Iraq,0,0,Friendly,Casablanca,Morocco,1977,7,12,0,0,0,0,draw,draw,318,3,0,0,0.68440029,0.466600071
11/12/1977,11,Tunisia,Tunisia,Egypt,Egypt,4,1,FIFA World Cup qualification,Tunis,Tunisia,1977,7,12,3,-3,3,5,winner,loser,319,3,1,1,0.70822323,0.694263796
18/01/1978,18,Libya,Libya,Morocco,Morocco,0,1,Friendly,Tripoli,Libya,1978,8,1,-1,1,1,1,loser,winner,320,3,0,0,0.81339827,0.845753457
21/02/1978,21,Iraq,Iraq,Algeria,Algeria,3,0,Friendly,Baghdad,Iraq,1978,8,2,3,-3,3,3,winner,loser,321,3,0,1,0.58817317,0.544987483
23/02/1978,23,Iraq,Iraq,Algeria,Algeria,1,0,Friendly,Baghdad,Iraq,1978,8,2,1,-1,1,1,winner,loser,322,3,0,1,0.55913803,0.915933208
26/02/1978,26,Syria,Syria,Algeria,Algeria,0,1,Friendly,Damascus,Syria,1978,8,2,-1,1,1,1,loser,winner,323,3,0,1,0.4964237,0.950345811
06/03/1978,6,Morocco,Morocco,Tunisia,Tunisia,1,1,African Cup of Nations,Kumasi,Ghana,1978,8,3,0,0,0,2,draw,draw,324,3,0,1,0.30586185,0.55229555
12/03/1978,12,Libya,Libya,Algeria,Algeria,1,0,Friendly,Tripoli,Libya,1978,8,3,1,-1,1,1,winner,loser,325,3,0,1,0.08032384,0.528416415
02/07/1978,2,Algeria,Algeria,Iraq,Iraq,1,1,Friendly,Algiers,Algeria,1978,8,7,0,0,0,2,draw,draw,326,3,1,0,0.26539705,0.913234778
04/07/1978,4,Algeria,Algeria,Iraq,Iraq,0,0,Friendly,Algiers,Algeria,1978,8,7,0,0,0,0,draw,draw,327,3,1,0,0.45222638,0.794947062
15/07/1978,15,Iraq,Iraq,Syria,Syria,2,1,Merdeka Tournament,Kuala Lumpur,Malaysia,1978,8,7,1,-1,1,3,winner,loser,328,3,0,0,0.74466652,0.570796259
20/09/1978,20,Libya,Libya,Yemen,Yemen,2,0,Friendly,Tripoli,Libya,1978,8,9,2,-2,2,2,winner,loser,329,3,0,1,0.34964191,0.568694066
19/12/1978,19,Syria,Syria,Tunisia,Tunisia,2,1,Friendly,Damascus,Syria,1978,8,12,1,-1,1,3,winner,loser,330,3,0,1,0.23027195,0.026660608
23/03/1979,23,Iraq,Iraq,Bahrain,Bahrain,4,0,Gulf Cup,Baghdad,Iraq,1979,9,3,4,-4,4,4,winner,loser,331,3,0,0,0.05918548,0.071084633
24/03/1979,24,Kuwait,Kuwait,Qatar,Qatar,3,1,Gulf Cup,Baghdad,Iraq,1979,9,3,2,-2,2,4,winner,loser,332,3,0,1,0.6071859,0.417626601
28/03/1979,28,Saudi Arabia,Saudi_Arabia,Oman,Oman,4,0,Gulf Cup,Baghdad,Iraq,1979,9,3,4,-4,4,4,winner,loser,336,3,0,1,0.96597419,0.352720681
27/03/1979,27,Iraq,Iraq,Qatar,Qatar,2,0,Gulf Cup,Baghdad,Iraq,1979,9,3,2,-2,2,2,winner,loser,334,3,0,1,0.13297735,0.12033462
06/12/1992,6,Kuwait,Kuwait,Saudi Arabia,Saudi_Arabia,1,2,Gulf Cup,Doha,Qatar,1992,2,12,-1,1,1,3,loser,winner,711,5,0,0,0.08769907,0.239021599
02/04/1979,2,Saudi Arabia,Saudi_Arabia,Bahrain,Bahrain,1,1,Gulf Cup,Baghdad,Iraq,1979,9,4,0,0,0,2,draw,draw,342,3,0,0,0.21004321,0.730577854
10/12/1992,10,Qatar,Qatar,Saudi Arabia,Saudi_Arabia,0,1,Gulf Cup,Doha,Qatar,1992,2,12,-1,1,1,1,loser,winner,716,5,1,0,0.73091154,0.457203751
30/03/1979,30,Bahrain,Bahrain,Oman,Oman,3,1,Gulf Cup,Baghdad,Iraq,1979,9,3,2,-2,2,4,winner,loser,338,3,0,1,0.24464922,0.646484938
30/03/1979,30,Iraq,Iraq,Kuwait,Kuwait,3,1,Gulf Cup,Baghdad,Iraq,1979,9,3,2,-2,2,4,winner,loser,339,3,0,0,0.08590883,0.707004514
01/04/1979,1,Oman,Oman,Qatar,Qatar,0,1,Gulf Cup,Baghdad,Iraq,1979,9,4,-1,1,1,1,loser,winner,340,3,1,1,0.67796217,0.880520764
05/05/1993,5,Kuwait,Kuwait,Saudi Arabia,Saudi_Arabia,0,0,FIFA World Cup qualification,Kuala Lumpur,Malaysia,1993,3,5,0,0,0,0,draw,draw,725,5,0,0,0.98812917,0.228859944
04/04/1979,4,Saudi Arabia,Saudi_Arabia,Qatar,Qatar,7,0,Gulf Cup,Baghdad,Iraq,1979,9,4,7,-7,7,7,winner,loser,344,3,0,1,0.31170399,0.326714935
03/04/1979,3,Kuwait,Kuwait,Oman,Oman,2,0,Gulf Cup,Baghdad,Iraq,1979,9,4,2,-2,2,2,winner,loser,343,3,0,1,0.38338423,0.446550136
08/03/1981,8,Saudi Arabia,Saudi_Arabia,Tunisia,Tunisia,1,2,Friendly,Riyadh,Saudi Arabia,1981,1,3,-1,1,1,3,loser,winner,374,4,0,1,0.90064007,0.640762508
24/10/1993,24,Iraq,Iraq,Saudi Arabia,Saudi_Arabia,1,1,FIFA World Cup qualification,Doha,Qatar,1993,3,10,0,0,0,2,draw,draw,738,5,0,0,0.16084694,0.310623033
06/04/1979,6,Iraq,Iraq,Oman,Oman,7,0,Gulf Cup,Baghdad,Iraq,1979,9,4,7,-7,7,7,winner,loser,346,3,0,1,0.38969046,0.818328702
18/04/1994,18,Tunisia,Tunisia,Saudi Arabia,Saudi_Arabia,2,0,Friendly,Tunis,Tunisia,1994,4,4,2,-2,2,2,winner,loser,745,5,1,0,0.0028834,0.489597512
07/04/1979,7,Bahrain,Bahrain,Qatar,Qatar,1,1,Gulf Cup,Baghdad,Iraq,1979,9,4,0,0,0,2,draw,draw,348,3,0,1,0.12137948,0.014797836
04/11/1994,4,Oman,Oman,Saudi Arabia,Saudi_Arabia,1,2,Gulf Cup,Abu Dhabi,United Arab Emirates,1994,4,11,-1,1,1,3,loser,winner,754,5,1,0,0.76428028,0.94322477
09/04/1979,9,Bahrain,Bahrain,Kuwait,Kuwait,0,2,Gulf Cup,Baghdad,Iraq,1979,9,4,-2,2,2,2,loser,winner,350,3,0,0,0.03857443,0.491605413
12/11/1994,12,Qatar,Qatar,Saudi Arabia,Saudi_Arabia,1,2,Gulf Cup,Abu Dhabi,United Arab Emirates,1994,4,11,-1,1,1,3,loser,winner,761,5,1,0,0.08184996,0.25881383
03/09/1979,3,Libya,Libya,Palestine,Palestine,0,0,Friendly,Tripoli,Libya,1979,9,9,0,0,0,0,draw,draw,352,3,0,0,0.21650506,0.476914838
27/02/1980,27,Morocco,Morocco,Tunisia,Tunisia,0,0,Friendly,Meknès,Morocco,1980,0,2,0,0,0,0,draw,draw,353,4,0,1,0.8822378,0.165826016
13/03/1980,13,Algeria,Algeria,Morocco,Morocco,1,0,African Cup of Nations,Ibadan,Nigeria,1980,0,3,1,-1,1,1,winner,loser,354,4,1,0,0.95680092,0.248599071
19/03/1980,19,Algeria,Algeria,Egypt,Egypt,2,2,African Cup of Nations,Ibadan,Nigeria,1980,0,3,0,0,0,4,draw,draw,355,4,1,1,0.6424427,0.338868449
21/03/1980,21,Egypt,Egypt,Morocco,Morocco,0,2,African Cup of Nations,Lagos,Nigeria,1980,0,3,-2,2,2,2,loser,winner,356,4,1,0,0.96364943,0.986107809
08/06/1980,8,Tunisia,Tunisia,Morocco,Morocco,0,1,Friendly,Tunis,Tunisia,1980,0,6,-1,1,1,1,loser,winner,357,4,1,0,0.37749802,0.480090151
16/11/1994,16,Kuwait,Kuwait,Saudi Arabia,Saudi_Arabia,0,2,Gulf Cup,Abu Dhabi,United Arab Emirates,1994,4,11,-2,2,2,2,loser,winner,765,5,0,0,0.82201753,0.977987539
15/10/1996,15,Oman,Oman,Saudi Arabia,Saudi_Arabia,0,1,Gulf Cup,Muscat,Oman,1996,6,10,-1,1,1,1,loser,winner,807,5,1,0,0.05015524,0.40826943
25/09/1980,25,Kuwait,Kuwait,Qatar,Qatar,4,0,AFC Asian Cup,Kuwait City,Kuwait,1980,0,9,4,-4,4,4,winner,loser,360,4,0,1,0.06852724,0.380225494
19/10/1996,19,Qatar,Qatar,Saudi Arabia,Saudi_Arabia,2,2,Gulf Cup,Muscat,Oman,1996,6,10,0,0,0,4,draw,draw,812,5,1,0,0.54153235,0.763218563
20/11/1980,20,Sudan,Sudan,Somalia,Somalia,2,0,CECAFA Cup,Khartoum,Sudan,1980,0,11,2,-2,2,2,winner,loser,362,4,1,1,0.83229095,0.019682866
12/12/1980,12,Algeria,Algeria,Sudan,Sudan,2,0,FIFA World Cup qualification,Constantine,Algeria,1980,0,12,2,-2,2,2,winner,loser,363,4,1,1,0.62638132,0.042627902
28/12/1980,28,Sudan,Sudan,Algeria,Algeria,1,1,FIFA World Cup qualification,Khartoum,Sudan,1980,0,12,0,0,0,2,draw,draw,364,4,1,1,0.92647051,0.208139586
11/01/1981,11,Tunisia,Tunisia,Qatar,Qatar,4,0,Friendly,Tunis,Tunisia,1981,1,1,4,-4,4,4,winner,loser,365,4,1,1,0.28324446,0.030094694
06/02/1981,6,Jordan,Jordan,Iraq,Iraq,0,2,Friendly,Amman,Jordan,1981,1,2,-2,2,2,2,loser,winner,366,4,1,0,0.11467834,0.032242357
08/02/1981,8,Jordan,Jordan,Iraq,Iraq,0,2,Friendly,Amman,Jordan,1981,1,2,-2,2,2,2,loser,winner,367,4,1,0,0.11285797,0.492916696
14/02/1981,14,Oman,Oman,Jordan,Jordan,0,1,Friendly,Muscat,Oman,1981,1,2,-1,1,1,1,loser,winner,368,4,1,1,0.5921228,0.202740476
15/02/1981,15,Morocco,Morocco,Syria,Syria,3,0,Friendly,Fès,Morocco,1981,1,2,3,-3,3,3,winner,loser,369,4,0,0,0.36689748,0.254273074
16/02/1981,16,Oman,Oman,Jordan,Jordan,0,2,Friendly,Muscat,Oman,1981,1,2,-2,2,2,2,loser,winner,370,4,1,1,0.42064516,0.723100706
27/02/1981,27,Bahrain,Bahrain,Jordan,Jordan,1,0,Friendly,Manama,Bahrain,1981,1,2,1,-1,1,1,winner,loser,371,4,0,1,0.56573882,0.200581284
05/03/1981,5,Bahrain,Bahrain,Tunisia,Tunisia,0,3,Friendly,Manama,Bahrain,1981,1,3,-3,3,3,3,loser,winner,372,4,0,1,0.85766993,0.600228235
08/03/1981,8,Morocco,Morocco,Iraq,Iraq,1,1,Friendly,Rabat,Morocco,1981,1,3,0,0,0,2,draw,draw,373,4,0,0,0.44641427,0.713935211
11/03/1981,11,Saudi Arabia,Saudi_Arabia,Jordan,Jordan,2,1,Friendly,Riyadh,Saudi Arabia,1981,1,3,1,-1,1,3,winner,loser,375,4,0,1,0.59828647,0.59678614
21/03/1981,21,Saudi Arabia,Saudi_Arabia,Iraq,Iraq,1,0,FIFA World Cup qualification,Riyadh,Saudi Arabia,1981,1,3,1,-1,1,1,winner,loser,378,4,0,0,0.60332987,0.485988291
18/03/1981,18,Qatar,Qatar,Iraq,Iraq,0,1,FIFA World Cup qualification,Riyadh,Saudi Arabia,1981,1,3,-1,1,1,1,loser,winner,376,4,1,0,0.19548527,0.908955985
19/03/1981,19,Syria,Syria,Bahrain,Bahrain,0,1,FIFA World Cup qualification,Riyadh,Saudi Arabia,1981,1,3,-1,1,1,1,loser,winner,377,4,0,0,0.56145212,0.703967775
24/03/1981,24,Saudi Arabia,Saudi_Arabia,Syria,Syria,2,0,FIFA World Cup qualification,Riyadh,Saudi Arabia,1981,1,3,2,-2,2,2,winner,loser,380,4,0,0,0.11153881,0.857874651
22/03/1981,22,Qatar,Qatar,Bahrain,Bahrain,3,0,FIFA World Cup qualification,Riyadh,Saudi Arabia,1981,1,3,3,-3,3,3,winner,loser,379,4,1,0,0.64958626,0.360205233
28/03/1981,28,Saudi Arabia,Saudi_Arabia,Bahrain,Bahrain,1,0,FIFA World Cup qualification,Riyadh,Saudi Arabia,1981,1,3,1,-1,1,1,winner,loser,383,4,0,0,0.78869286,0.625617489
25/03/1981,25,Iraq,Iraq,Bahrain,Bahrain,2,0,FIFA World Cup qualification,Riyadh,Saudi Arabia,1981,1,3,2,-2,2,2,winner,loser,381,4,0,0,0.80642362,0.798231391
27/03/1981,27,Qatar,Qatar,Syria,Syria,2,1,FIFA World Cup qualification,Riyadh,Saudi Arabia,1981,1,3,1,-1,1,3,winner,loser,382,4,1,0,0.73527591,0.124227943
31/03/1981,31,Saudi Arabia,Saudi_Arabia,Qatar,Qatar,1,0,FIFA World Cup qualification,Riyadh,Saudi Arabia,1981,1,3,1,-1,1,1,winner,loser,385,4,0,1,0.58723805,0.849174501
30/03/1981,30,Iraq,Iraq,Syria,Syria,2,1,FIFA World Cup qualification,Riyadh,Saudi Arabia,1981,1,3,1,-1,1,3,winner,loser,384,4,0,0,0.68462862,0.369041646
04/11/1981,4,Saudi Arabia,Saudi_Arabia,Kuwait,Kuwait,0,1,FIFA World Cup qualification,Riyadh,Saudi Arabia,1981,1,11,-1,1,1,1,loser,winner,389,4,0,0,0.98419543,0.89229689
26/04/1981,26,Morocco,Morocco,Egypt,Egypt,1,0,FIFA World Cup qualification,Casablanca,Morocco,1981,1,4,1,-1,1,1,winner,loser,386,4,0,1,0.57263239,0.268139028
08/05/1981,8,Egypt,Egypt,Morocco,Morocco,0,0,FIFA World Cup qualification,Cairo,Egypt,1981,1,5,0,0,0,0,draw,draw,387,4,1,0,0.03470622,0.3088012
27/09/1981,27,Morocco,Morocco,Tunisia,Tunisia,2,2,Friendly,Kénitra,Morocco,1981,1,9,0,0,0,4,draw,draw,388,4,0,1,0.06153625,0.40042311
26/03/1982,26,Saudi Arabia,Saudi_Arabia,Kuwait,Kuwait,0,1,Gulf Cup,Abu Dhabi,United Arab Emirates,1982,2,3,-1,1,1,1,loser,winner,401,4,0,0,0.15391387,0.457056847
24/10/1996,24,Kuwait,Kuwait,Saudi Arabia,Saudi_Arabia,1,0,Gulf Cup,Muscat,Oman,1996,6,10,1,-1,1,1,winner,loser,816,5,0,0,0.28246585,0.146200745
29/03/1982,29,Saudi Arabia,Saudi_Arabia,Qatar,Qatar,1,0,Gulf Cup,Abu Dhabi,United Arab Emirates,1982,2,3,1,-1,1,1,winner,loser,404,4,0,1,0.36451818,0.442380398
07/02/1982,7,Tunisia,Tunisia,Algeria,Algeria,0,1,Friendly,Tunis,Tunisia,1982,2,2,-1,1,1,1,loser,winner,392,4,1,1,0.94708235,0.355344086
19/02/1982,19,Libya,Libya,Qatar,Qatar,2,1,Friendly,Tripoli,Libya,1982,2,2,1,-1,1,3,winner,loser,393,4,0,1,0.59317217,0.20919131
09/03/1982,9,Libya,Libya,Tunisia,Tunisia,2,0,African Cup of Nations,Tripoli,Libya,1982,2,3,2,-2,2,2,winner,loser,394,4,0,1,0.80154017,0.220326383
31/03/1982,31,Saudi Arabia,Saudi_Arabia,Oman,Oman,3,0,Gulf Cup,Abu Dhabi,United Arab Emirates,1982,2,3,3,-3,3,3,winner,loser,406,4,0,1,0.44394798,0.398969476
20/03/1982,20,Bahrain,Bahrain,Kuwait,Kuwait,0,2,Gulf Cup,Abu Dhabi,United Arab Emirates,1982,2,3,-2,2,2,2,loser,winner,396,4,0,0,0.70774158,0.445101856
03/10/1982,3,Saudi Arabia,Saudi_Arabia,Morocco,Morocco,2,1,Friendly,Riyadh,Saudi Arabia,1982,2,10,1,-1,1,3,winner,loser,410,4,0,0,0.65097067,0.535104195
22/03/1982,22,Oman,Oman,Qatar,Qatar,0,3,Gulf Cup,Abu Dhabi,United Arab Emirates,1982,2,3,-3,3,3,3,loser,winner,398,4,1,1,0.61659395,0.587629283
21/02/1984,21,Saudi Arabia,Saudi_Arabia,Algeria,Algeria,4,2,Friendly,Riyadh,Saudi Arabia,1984,4,2,2,-2,2,6,winner,loser,418,4,0,1,0.32012375,0.297021996
25/03/1982,25,Bahrain,Bahrain,Oman,Oman,4,1,Gulf Cup,Abu Dhabi,United Arab Emirates,1982,2,3,3,-3,3,5,winner,loser,400,4,0,1,0.92587583,0.01144458
10/03/1984,10,Saudi Arabia,Saudi_Arabia,Qatar,Qatar,1,2,Gulf Cup,Muscat,Oman,1984,4,3,-1,1,1,3,loser,winner,423,4,0,1,0.34741493,0.53976954
20/03/1984,20,Saudi Arabia,Saudi_Arabia,Kuwait,Kuwait,1,1,Gulf Cup,Muscat,Oman,1984,4,3,0,0,0,2,draw,draw,435,4,0,0,0.10665778,0.013487012
29/03/1982,29,Kuwait,Kuwait,Oman,Oman,2,0,Gulf Cup,Abu Dhabi,United Arab Emirates,1982,2,3,2,-2,2,2,winner,loser,403,4,0,1,0.82927648,0.911058845
17/10/1997,17,Kuwait,Kuwait,Saudi Arabia,Saudi_Arabia,2,1,FIFA World Cup qualification,Kuwait City,Kuwait,1997,7,10,1,-1,1,3,winner,loser,863,5,0,0,0.96799386,0.05594857
31/03/1982,31,Bahrain,Bahrain,Qatar,Qatar,1,0,Gulf Cup,Abu Dhabi,United Arab Emirates,1982,2,3,1,-1,1,1,winner,loser,405,4,0,1,0.29720851,0.271018544
12/11/1997,12,Qatar,Qatar,Saudi Arabia,Saudi_Arabia,0,1,FIFA World Cup qualification,Doha,Qatar,1997,7,11,-1,1,1,1,loser,winner,865,5,1,0,0.82726112,0.616340238
01/10/1998,1,Qatar,Qatar,Saudi Arabia,Saudi_Arabia,1,3,UAFA Cup,Doha,Qatar,1998,8,10,-2,2,2,4,loser,winner,895,5,1,0,0.5981136,0.001258546
26/10/1984,26,Saudi Arabia,Saudi_Arabia,Oman,Oman,6,0,AFC Asian Cup qualification,Jeddah,Saudi Arabia,1984,4,10,6,-6,6,6,winner,loser,447,4,0,1,0.88683799,0.169623287
04/04/1982,4,Kuwait,Kuwait,Qatar,Qatar,1,2,Gulf Cup,Abu Dhabi,United Arab Emirates,1982,2,4,-1,1,1,3,loser,winner,409,4,0,1,0.70661685,0.899780017
11/12/1984,11,Saudi Arabia,Saudi_Arabia,Kuwait,Kuwait,1,0,AFC Asian Cup,Kallang,Singapore,1984,4,12,1,-1,1,1,winner,loser,454,4,0,0,0.65205535,0.902172006
19/12/1982,19,Tunisia,Tunisia,Algeria,Algeria,0,1,Friendly,Tunis,Tunisia,1982,2,12,-1,1,1,1,loser,winner,411,4,1,1,0.26972686,0.074698865
23/03/1983,23,Tunisia,Tunisia,Morocco,Morocco,1,0,Friendly,Sousse,Tunisia,1983,3,3,1,-1,1,1,winner,loser,412,4,1,0,0.94776426,0.425583679
28/04/1983,28,Iraq,Iraq,Egypt,Egypt,2,1,Friendly,Baghdad,Iraq,1983,3,4,1,-1,1,3,winner,loser,413,4,0,1,0.81574877,0.134398674
08/07/1983,8,Qatar,Qatar,Sudan,Sudan,3,1,Friendly,Doha,Qatar,1983,3,7,2,-2,2,4,winner,loser,414,4,1,1,0.64815007,0.483491414
10/07/1983,10,Qatar,Qatar,Sudan,Sudan,2,0,Friendly,Doha,Qatar,1983,3,7,2,-2,2,2,winner,loser,415,4,1,1,0.78030639,0.042765027
14/08/1983,14,Egypt,Egypt,Tunisia,Tunisia,1,0,African Cup of Nations qualification,Cairo,Egypt,1983,3,8,1,-1,1,1,winner,loser,416,4,1,1,0.86096608,0.399509011
28/08/1983,28,Tunisia,Tunisia,Egypt,Egypt,0,0,African Cup of Nations qualification,Tunis,Tunisia,1983,3,8,0,0,0,0,draw,draw,417,4,1,1,0.37736789,0.353608624
31/10/1998,31,Kuwait,Kuwait,Saudi Arabia,Saudi_Arabia,1,2,Gulf Cup,Manama,Bahrain,1998,8,10,-1,1,1,3,loser,winner,904,5,0,0,0.26363196,0.015029472
27/02/1984,27,Egypt,Egypt,Iraq,Iraq,1,2,Friendly,Cairo,Egypt,1984,4,2,-1,1,1,3,loser,winner,419,4,1,0,0.43971299,0.494414949
29/02/1984,29,Egypt,Egypt,Iraq,Iraq,0,0,Friendly,Cairo,Egypt,1984,4,2,0,0,0,0,draw,draw,420,4,1,0,0.99443475,0.183949265
09/03/1984,9,Oman,Oman,Bahrain,Bahrain,0,1,Gulf Cup,Muscat,Oman,1984,4,3,-1,1,1,1,loser,winner,421,4,1,0,0.35803872,0.601217293
02/11/1998,2,Bahrain,Bahrain,Saudi Arabia,Saudi_Arabia,1,1,Gulf Cup,Manama,Bahrain,1998,8,11,0,0,0,2,draw,draw,906,5,0,0,0.42792698,0.165679551
03/07/1985,3,Saudi Arabia,Saudi_Arabia,Jordan,Jordan,4,0,UAFA Cup,Ta'if,Saudi Arabia,1985,5,7,4,-4,4,4,winner,loser,487,4,0,1,0.31218574,0.13819871
11/03/1984,11,Oman,Oman,Iraq,Iraq,1,2,Gulf Cup,Muscat,Oman,1984,4,3,-1,1,1,3,loser,winner,424,4,1,0,0.18020906,0.058682988
12/03/1984,12,Bahrain,Bahrain,Kuwait,Kuwait,0,1,Gulf Cup,Muscat,Oman,1984,4,3,-1,1,1,1,loser,winner,425,4,0,0,0.84817896,0.824393441
05/11/1998,5,Oman,Oman,Saudi Arabia,Saudi_Arabia,0,1,Gulf Cup,Manama,Bahrain,1998,8,11,-1,1,1,1,loser,winner,909,5,1,0,0.35462662,0.685795902
11/11/1998,11,Qatar,Qatar,Saudi Arabia,Saudi_Arabia,0,0,Gulf Cup,Manama,Bahrain,1998,8,11,0,0,0,0,draw,draw,915,5,1,0,0.64168446,0.065884236
29/07/1999,29,Egypt,Egypt,Saudi Arabia,Saudi_Arabia,1,5,Confederations Cup,Mexico City,Mexico,1999,9,7,-4,4,4,6,loser,winner,926,5,1,0,0.66472403,0.466345627
16/03/1984,16,Kuwait,Kuwait,Qatar,Qatar,1,2,Gulf Cup,Muscat,Oman,1984,4,3,-1,1,1,3,loser,winner,429,4,0,1,0.94372782,0.165090815
17/03/1984,17,Algeria,Algeria,Egypt,Egypt,3,1,African Cup of Nations,Abidjan,Ivory Coast,1984,4,3,2,-2,2,4,winner,loser,430,4,1,1,0.92019401,0.732452342
21/05/2000,21,Lebanon,Lebanon,Saudi Arabia,Saudi_Arabia,0,0,Friendly,Zahlé,Lebanon,2000,0,5,0,0,0,0,draw,draw,951,6,1,0,0.40353614,0.601063228
02/10/2000,2,Jordan,Jordan,Saudi Arabia,Saudi_Arabia,1,0,Friendly,Amman,Jordan,2000,0,10,1,-1,1,1,winner,loser,973,6,1,0,0.77328533,0.477861577
18/03/1984,18,Oman,Oman,Qatar,Qatar,0,2,Gulf Cup,Muscat,Oman,1984,4,3,-2,2,2,2,loser,winner,433,4,1,1,0.05476679,0.056005848
20/03/1984,20,Bahrain,Bahrain,Iraq,Iraq,0,1,Gulf Cup,Muscat,Oman,1984,4,3,-1,1,1,1,loser,winner,434,4,0,0,0.81937877,0.820605977
07/07/1985,7,Saudi Arabia,Saudi_Arabia,Qatar,Qatar,1,0,UAFA Cup,Ta'if,Saudi Arabia,1985,5,7,1,-1,1,1,winner,loser,491,4,0,1,0.08901865,0.647855016
24/10/2000,24,Kuwait,Kuwait,Saudi Arabia,Saudi_Arabia,2,3,AFC Asian Cup,Beirut,Lebanon,2000,0,10,-1,1,1,5,loser,winner,979,6,0,0,0.10120217,0.007145012
22/03/1984,22,Bahrain,Bahrain,Qatar,Qatar,1,1,Gulf Cup,Muscat,Oman,1984,4,3,0,0,0,2,draw,draw,437,4,0,1,0.19335314,0.86063197
22/03/1984,22,Iraq,Iraq,Kuwait,Kuwait,3,1,Gulf Cup,Muscat,Oman,1984,4,3,2,-2,2,4,winner,loser,438,4,0,0,0.25148906,0.965322955
10/07/1985,10,Saudi Arabia,Saudi_Arabia,Iraq,Iraq,2,3,UAFA Cup,Ta'if,Saudi Arabia,1985,5,7,-1,1,1,5,loser,winner,494,4,0,0,0.95128052,0.145306257
25/03/1984,25,Iraq,Iraq,Qatar,Qatar,1,2,Gulf Cup,Muscat,Oman,1984,4,3,-1,1,1,3,loser,winner,440,4,0,1,0.85452728,0.658633646
25/03/1984,25,Oman,Oman,Kuwait,Kuwait,0,0,Gulf Cup,Muscat,Oman,1984,4,3,0,0,0,0,draw,draw,441,4,1,0,0.82946653,0.909463954
21/09/2001,21,Bahrain,Bahrain,Saudi Arabia,Saudi_Arabia,0,4,FIFA World Cup qualification,Riffa,Bahrain,2001,1,9,-4,4,4,4,loser,winner,1028,6,0,0,0.5577838,0.365535176
28/03/1984,28,Iraq,Iraq,Qatar,Qatar,1,1,Gulf Cup,Muscat,Oman,1984,4,3,0,0,0,2,draw,draw,443,4,0,1,0.69920929,0.981301791
17/09/1984,17,Qatar,Qatar,Jordan,Jordan,2,0,AFC Asian Cup qualification,Guangzhou,China PR,1984,4,9,2,-2,2,2,winner,loser,444,4,1,1,0.20501496,0.177472718
12/07/1985,12,Saudi Arabia,Saudi_Arabia,Qatar,Qatar,0,0,UAFA Cup,Ta'if,Saudi Arabia,1985,5,7,0,0,0,0,draw,draw,497,4,0,1,0.64430307,0.264588493
17/02/1986,17,Saudi Arabia,Saudi_Arabia,Algeria,Algeria,0,0,Friendly,Khobar,Saudi Arabia,1986,6,2,0,0,0,0,draw,draw,512,4,0,1,0.97592855,0.687152951
21/02/1986,21,Saudi Arabia,Saudi_Arabia,Algeria,Algeria,1,1,Friendly,Khobar,Saudi Arabia,1986,6,2,0,0,0,2,draw,draw,513,4,0,1,0.39824793,0.382418296
23/03/1986,23,Saudi Arabia,Saudi_Arabia,Kuwait,Kuwait,1,3,Gulf Cup,Riffa,Bahrain,1986,6,3,-2,2,2,4,loser,winner,518,4,0,0,0.32199368,0.327253622
01/12/1984,1,Qatar,Qatar,Syria,Syria,1,1,AFC Asian Cup,Kallang,Singapore,1984,4,12,0,0,0,2,draw,draw,449,4,1,0,0.65458402,0.788225647
03/12/1984,3,Kuwait,Kuwait,Qatar,Qatar,1,0,AFC Asian Cup,Kallang,Singapore,1984,4,12,1,-1,1,1,winner,loser,450,4,0,1,0.90508141,0.099557224
05/10/2001,5,Iraq,Iraq,Saudi Arabia,Saudi_Arabia,1,2,FIFA World Cup qualification,Amman,Jordan,2001,1,10,-1,1,1,3,loser,winner,1033,6,0,0,0.22684444,0.396740168
24/12/2002,24,Syria,Syria,Saudi Arabia,Saudi_Arabia,0,3,UAFA Cup,Kuwait City,Kuwait,2002,2,12,-3,3,3,3,loser,winner,1093,6,0,0,0.79482748,0.788793246
09/12/1984,9,Kuwait,Kuwait,Syria,Syria,3,1,AFC Asian Cup,Kallang,Singapore,1984,4,12,2,-2,2,4,winner,loser,453,4,0,0,0.04245165,0.545067358
28/03/1986,28,Saudi Arabia,Saudi_Arabia,Oman,Oman,3,1,Gulf Cup,Riffa,Bahrain,1986,6,3,2,-2,2,4,winner,loser,523,4,0,1,0.09044077,0.130122659
30/12/1984,30,Algeria,Algeria,Tunisia,Tunisia,3,1,Friendly,Abidjan,Ivory Coast,1984,4,12,2,-2,2,4,winner,loser,455,4,1,1,0.39995127,0.248389456
02/01/1985,2,Libya,Libya,Morocco,Morocco,0,0,Friendly,Tripoli,Libya,1985,5,1,0,0,0,0,draw,draw,456,4,0,0,0.4314709,0.157528923
22/02/1985,22,Sudan,Sudan,Libya,Libya,0,0,FIFA World Cup qualification,Khartoum,Sudan,1985,5,2,0,0,0,0,draw,draw,457,4,1,0,0.60378862,0.251473977
08/03/1985,8,Algeria,Algeria,Mauritania,Mauritania,4,0,African Cup of Nations qualification,Algiers,Algeria,1985,5,3,4,-4,4,4,winner,loser,458,4,1,1,0.60417463,0.200825836
08/03/1985,8,Libya,Libya,Sudan,Sudan,4,0,FIFA World Cup qualification,Tripoli,Libya,1985,5,3,4,-4,4,4,winner,loser,459,4,0,1,0.23305267,0.343113581
15/03/1985,15,Iraq,Iraq,Lebanon,Lebanon,6,0,FIFA World Cup qualification,Kuwait City,Kuwait,1985,5,3,6,-6,6,6,winner,loser,460,4,0,1,0.39244028,0.602513709
15/03/1985,15,Jordan,Jordan,Qatar,Qatar,1,0,FIFA World Cup qualification,Amman,Jordan,1985,5,3,1,-1,1,1,winner,loser,461,4,1,1,0.52519164,0.498347767
18/03/1985,18,Iraq,Iraq,Lebanon,Lebanon,6,0,FIFA World Cup qualification,Kuwait City,Kuwait,1985,5,3,6,-6,6,6,winner,loser,462,4,0,1,0.48592547,0.960648296
22/03/1985,22,Mauritania,Mauritania,Algeria,Algeria,1,1,African Cup of Nations qualification,Nouakchott,Mauritania,1985,5,3,0,0,0,2,draw,draw,463,4,1,1,0.45233746,0.143572277
22/03/1985,22,Qatar,Qatar,Lebanon,Lebanon,7,0,FIFA World Cup qualification,Doha,Qatar,1985,5,3,7,-7,7,7,winner,loser,464,4,1,1,0.33485844,0.808705333
22/03/1985,22,Syria,Syria,Kuwait,Kuwait,1,0,FIFA World Cup qualification,Damascus,Syria,1985,5,3,1,-1,1,1,winner,loser,465,4,0,0,0.61574561,0.198349179
27/03/1985,27,Qatar,Qatar,Lebanon,Lebanon,8,0,FIFA World Cup qualification,Doha,Qatar,1985,5,3,8,-8,8,8,winner,loser,466,4,1,1,0.33279169,0.56524736
29/03/1985,29,Jordan,Jordan,Iraq,Iraq,2,3,FIFA World Cup qualification,Amman,Jordan,1985,5,3,-1,1,1,5,loser,winner,467,4,1,0,0.29829364,0.911474586
29/03/1985,29,Libya,Libya,Tunisia,Tunisia,2,0,African Cup of Nations qualification,Tripoli,Libya,1985,5,3,2,-2,2,2,winner,loser,468,4,0,1,0.0774286,0.237375789
29/03/1985,29,Yemen,Yemen,Syria,Syria,0,1,FIFA World Cup qualification,Sana'a,Yemen AR,1985,5,3,-1,1,1,1,loser,winner,469,4,1,0,0.1554326,0.757395897
29/03/1985,29,Yemen,Yemen,Bahrain,Bahrain,1,4,FIFA World Cup qualification,Aden,Yemen DPR,1985,5,3,-3,3,3,5,loser,winner,470,4,1,0,0.89899717,0.690029636
26/12/2002,26,Yemen,Yemen,Saudi Arabia,Saudi_Arabia,2,2,UAFA Cup,Kuwait City,Kuwait,2002,2,12,0,0,0,4,draw,draw,1096,6,1,0,0.19806011,0.206001218
21/03/1982,21,UAE,UAE,Saudi Arabia,Saudi_Arabia,1,0,Gulf Cup,Abu Dhabi,United Arab Emirates,1982,2,3,1,-1,1,1,winner,loser,397,4,0,0,0.28880496,0.410520828
05/04/1985,5,Kuwait,Kuwait,Yemen,Yemen,5,0,FIFA World Cup qualification,Kuwait City,Kuwait,1985,5,4,5,-5,5,5,winner,loser,473,4,0,1,0.54176235,0.176315046
05/04/1985,5,Qatar,Qatar,Iraq,Iraq,3,0,FIFA World Cup qualification,Doha,Qatar,1985,5,4,3,-3,3,3,winner,loser,474,4,1,0,0.24305119,0.257173949
01/01/2004,1,Bahrain,Bahrain,Saudi Arabia,Saudi_Arabia,0,1,Gulf Cup,Kuwait City,Kuwait,2004,4,1,-1,1,1,1,loser,winner,1140,6,0,0,0.41044862,0.14962992
12/04/1985,12,Bahrain,Bahrain,Yemen,Yemen,3,3,FIFA World Cup qualification,Riffa,Bahrain,1985,5,4,0,0,0,6,draw,draw,476,4,0,1,0.20021732,0.442766544
12/04/1985,12,Kuwait,Kuwait,Syria,Syria,0,0,FIFA World Cup qualification,Kuwait City,Kuwait,1985,5,4,0,0,0,0,draw,draw,477,4,0,0,0.27256601,0.727265694
12/04/1985,12,Qatar,Qatar,Jordan,Jordan,2,0,FIFA World Cup qualification,Doha,Qatar,1985,5,4,2,-2,2,2,winner,loser,478,4,1,1,0.34544336,0.793558016
04/01/2004,4,Kuwait,Kuwait,Saudi Arabia,Saudi_Arabia,1,1,Gulf Cup,Kuwait City,Kuwait,2004,4,1,0,0,0,2,draw,draw,1144,6,0,0,0.46038768,0.820137411
14/04/1985,14,Tunisia,Tunisia,Libya,Libya,1,0,African Cup of Nations qualification,Tunis,Tunisia,1985,5,4,1,-1,1,1,winner,loser,480,4,1,0,0.74031266,0.294184651
19/04/1985,19,Iraq,Iraq,Jordan,Jordan,2,0,FIFA World Cup qualification,Kuwait City,Kuwait,1985,5,4,2,-2,2,2,winner,loser,481,4,0,1,0.54068775,0.988403502
19/04/1985,19,Syria,Syria,Yemen,Yemen,3,0,FIFA World Cup qualification,Damascus,Syria,1985,5,4,3,-3,3,3,winner,loser,482,4,0,1,0.09287368,0.068041056
02/03/1988,2,Saudi Arabia,Saudi_Arabia,Oman,Oman,2,0,Gulf Cup,Riyadh,Saudi Arabia,1988,8,3,2,-2,2,2,winner,loser,559,4,0,1,0.29885447,0.78712111
26/04/1985,26,Yemen,Yemen,Kuwait,Kuwait,1,3,FIFA World Cup qualification,Sana'a,Yemen AR,1985,5,4,-2,2,2,4,loser,winner,484,4,1,0,0.27686042,0.569475885
01/05/1985,1,Tunisia,Tunisia,Algeria,Algeria,1,0,Friendly,Tunis,Tunisia,1985,5,5,1,-1,1,1,winner,loser,485,4,1,1,0.6561212,0.040339156
05/05/1985,5,Iraq,Iraq,Qatar,Qatar,2,1,FIFA World Cup qualification,Calcutta,India,1985,5,5,1,-1,1,3,winner,loser,486,4,0,1,0.40968547,0.408570193
05/03/1988,5,Saudi Arabia,Saudi_Arabia,Qatar,Qatar,0,0,Gulf Cup,Riyadh,Saudi Arabia,1988,8,3,0,0,0,0,draw,draw,564,4,0,1,0.14042989,0.24705662
04/07/1985,4,Bahrain,Bahrain,Iraq,Iraq,1,1,UAFA Cup,Ta'if,Saudi Arabia,1985,5,7,0,0,0,2,draw,draw,488,4,0,0,0.29287044,0.680429927
05/07/1985,5,Jordan,Jordan,Qatar,Qatar,0,2,UAFA Cup,Ta'if,Saudi Arabia,1985,5,7,-2,2,2,2,loser,winner,489,4,1,1,0.25577547,0.118741846
06/07/1985,6,Bahrain,Bahrain,Mauritania,Mauritania,2,0,UAFA Cup,Ta'if,Saudi Arabia,1985,5,7,2,-2,2,2,winner,loser,490,4,0,1,0.19986273,0.877867683
09/03/1988,9,Saudi Arabia,Saudi_Arabia,Bahrain,Bahrain,1,0,Gulf Cup,Riyadh,Saudi Arabia,1988,8,3,1,-1,1,1,winner,loser,568,4,0,0,0.61007333,0.343467499
08/07/1985,8,Iraq,Iraq,Mauritania,Mauritania,2,0,UAFA Cup,Ta'if,Saudi Arabia,1985,5,7,2,-2,2,2,winner,loser,492,4,0,1,0.41478551,0.768928828
10/07/1985,10,Bahrain,Bahrain,Qatar,Qatar,1,1,UAFA Cup,Ta'if,Saudi Arabia,1985,5,7,0,0,0,2,draw,draw,493,4,0,1,0.94904948,0.715885364
06/01/2004,6,Oman,Oman,Saudi Arabia,Saudi_Arabia,1,2,Gulf Cup,Kuwait City,Kuwait,2004,4,1,-1,1,1,3,loser,winner,1146,6,1,0,0.55882548,0.566589041
12/07/1985,12,Bahrain,Bahrain,Iraq,Iraq,0,1,UAFA Cup,Ta'if,Saudi Arabia,1985,5,7,-1,1,1,1,loser,winner,495,4,0,0,0.64336924,0.945160989
12/07/1985,12,Egypt,Egypt,Morocco,Morocco,0,0,FIFA World Cup qualification,Cairo,Egypt,1985,5,7,0,0,0,0,draw,draw,496,4,1,0,0.68145125,0.555730249
16/03/1988,16,Saudi Arabia,Saudi_Arabia,Iraq,Iraq,0,2,Gulf Cup,Riyadh,Saudi Arabia,1988,8,3,-2,2,2,2,loser,winner,577,4,0,0,0.82375659,0.785281898
28/07/1985,28,Morocco,Morocco,Egypt,Egypt,2,0,FIFA World Cup qualification,Casablanca,Morocco,1985,5,7,2,-2,2,2,winner,loser,498,4,0,1,0.42945011,0.461503805
08/01/2004,8,Yemen,Yemen,Saudi Arabia,Saudi_Arabia,0,2,Gulf Cup,Kuwait City,Kuwait,2004,4,1,-2,2,2,2,loser,winner,1149,6,1,0,0.38784533,0.617388052
06/09/1985,6,Bahrain,Bahrain,Syria,Syria,1,1,FIFA World Cup qualification,Riffa,Bahrain,1985,5,9,0,0,0,2,draw,draw,500,4,0,0,0.52289083,0.67202666
20/09/1985,20,Syria,Syria,Bahrain,Bahrain,1,0,FIFA World Cup qualification,Damascus,Syria,1985,5,9,1,-1,1,1,winner,loser,501,4,0,0,0.32317575,0.218695964
18/03/1988,18,Saudi Arabia,Saudi_Arabia,Kuwait,Kuwait,0,0,Gulf Cup,Riyadh,Saudi Arabia,1988,8,3,0,0,0,0,draw,draw,580,4,0,0,0.91619368,0.357095634
19/04/1985,19,UAE,UAE,Saudi Arabia,Saudi_Arabia,1,0,FIFA World Cup qualification,Dubai,United Arab Emirates,1985,5,4,1,-1,1,1,winner,loser,483,4,0,0,0.70845666,0.130759661
06/10/1985,6,Morocco,Morocco,Libya,Libya,3,0,FIFA World Cup qualification,Rabat,Morocco,1985,5,10,3,-3,3,3,winner,loser,504,4,0,0,0.41939608,0.026820794
06/10/1985,6,Tunisia,Tunisia,Algeria,Algeria,1,4,FIFA World Cup qualification,Tunis,Tunisia,1985,5,10,-3,3,3,5,loser,winner,505,4,1,1,0.90384778,0.015362717
18/10/1985,18,Algeria,Algeria,Tunisia,Tunisia,3,0,FIFA World Cup qualification,Algiers,Algeria,1985,5,10,3,-3,3,3,winner,loser,506,4,1,1,0.32834915,0.682297255
18/10/1985,18,Libya,Libya,Morocco,Morocco,1,0,FIFA World Cup qualification,Bin Ghashir,Libya,1985,5,10,1,-1,1,1,winner,loser,507,4,0,0,0.93612164,0.010319774
15/11/1985,15,Syria,Syria,Iraq,Iraq,0,0,FIFA World Cup qualification,Damascus,Syria,1985,5,11,0,0,0,0,draw,draw,508,4,0,0,0.89015701,0.170304009
29/11/1985,29,Iraq,Iraq,Syria,Syria,3,1,FIFA World Cup qualification,Ta'if,Saudi Arabia,1985,5,11,2,-2,2,4,winner,loser,509,4,0,0,0.60380858,0.737026788
24/01/1986,24,Qatar,Qatar,Tunisia,Tunisia,2,1,Friendly,Doha,Qatar,1986,6,1,1,-1,1,3,winner,loser,510,4,1,1,0.85281163,0.40231659
27/01/1986,27,Oman,Oman,Tunisia,Tunisia,0,0,Friendly,Muscat,Oman,1986,6,1,0,0,0,0,draw,draw,511,4,1,1,0.03947371,0.52555899
11/07/1988,11,Saudi Arabia,Saudi_Arabia,Tunisia,Tunisia,1,1,UAFA Cup,Amman,Jordan,1988,8,7,0,0,0,2,draw,draw,591,4,0,1,0.1132294,0.62294311
14/11/1988,14,Saudi Arabia,Saudi_Arabia,Egypt,Egypt,0,0,Friendly,Riyadh,Saudi Arabia,1988,8,11,0,0,0,0,draw,draw,608,4,0,1,0.7891696,0.87772933
08/03/1986,8,Algeria,Algeria,Morocco,Morocco,0,0,African Cup of Nations,Alexandria,Egypt,1986,6,3,0,0,0,0,draw,draw,514,4,1,0,0.39947685,0.865517953
17/03/1986,17,Egypt,Egypt,Morocco,Morocco,1,0,African Cup of Nations,Cairo,Egypt,1986,6,3,1,-1,1,1,winner,loser,515,4,1,0,0.78174301,0.035793181
22/03/1986,22,Bahrain,Bahrain,Iraq,Iraq,0,0,Gulf Cup,Riffa,Bahrain,1986,6,3,0,0,0,0,draw,draw,516,4,0,0,0.01528156,0.602736605
23/03/1986,23,Qatar,Qatar,Oman,Oman,2,1,Gulf Cup,Riffa,Bahrain,1986,6,3,1,-1,1,3,winner,loser,517,4,1,1,0.99097177,0.243140956
29/11/1988,29,Saudi Arabia,Saudi_Arabia,Tunisia,Tunisia,1,0,Friendly,Khobar,Saudi Arabia,1988,8,11,1,-1,1,1,winner,loser,613,4,0,1,0.28159586,0.316361534
05/12/1988,5,Saudi Arabia,Saudi_Arabia,Kuwait,Kuwait,0,0,AFC Asian Cup,Doha,Qatar,1988,8,12,0,0,0,0,draw,draw,617,4,0,0,0.18451644,0.533827196
17/12/2004,17,Bahrain,Bahrain,Saudi Arabia,Saudi_Arabia,3,0,Gulf Cup,Rayyan,Qatar,2004,4,12,3,-3,3,3,winner,loser,1223,6,0,0,0.32241829,0.822774628
25/03/1986,25,Kuwait,Kuwait,Oman,Oman,2,0,Gulf Cup,Riffa,Bahrain,1986,6,3,2,-2,2,2,winner,loser,521,4,0,1,0.61241279,0.026418516
27/03/1986,27,Qatar,Qatar,Iraq,Iraq,1,1,Gulf Cup,Riffa,Bahrain,1986,6,3,0,0,0,2,draw,draw,522,4,1,0,0.01562247,0.939484648
09/12/1988,9,Saudi Arabia,Saudi_Arabia,Bahrain,Bahrain,1,1,AFC Asian Cup,Doha,Qatar,1988,8,12,0,0,0,2,draw,draw,620,4,0,0,0.72689055,0.263054452
15/03/1989,15,Saudi Arabia,Saudi_Arabia,Syria,Syria,5,4,FIFA World Cup qualification,Jeddah,Saudi Arabia,1989,9,3,1,-1,1,9,winner,loser,638,4,0,0,0.65928151,0.625065621
29/03/1986,29,Bahrain,Bahrain,Qatar,Qatar,0,0,Gulf Cup,Riffa,Bahrain,1986,6,3,0,0,0,0,draw,draw,525,4,0,1,0.56933057,0.928973052
30/03/2005,30,Kuwait,Kuwait,Saudi Arabia,Saudi_Arabia,0,0,FIFA World Cup qualification,Kuwait City,Kuwait,2005,5,3,0,0,0,0,draw,draw,1234,6,0,0,0.00643344,0.684211063
05/12/2005,5,Iraq,Iraq,Saudi Arabia,Saudi_Arabia,5,1,Friendly,Rayyan,Qatar,2005,5,12,4,-4,4,6,winner,loser,1259,6,0,0,0.1648604,0.899991187
01/04/1986,1,Kuwait,Kuwait,Qatar,Qatar,2,1,Gulf Cup,Riffa,Bahrain,1986,6,4,1,-1,1,3,winner,loser,528,4,0,1,0.09345842,0.862489032
02/04/1986,2,Bahrain,Bahrain,Oman,Oman,0,0,Gulf Cup,Riffa,Bahrain,1986,6,4,0,0,0,0,draw,draw,529,4,0,1,0.92123642,0.798420353
05/04/1989,5,Saudi Arabia,Saudi_Arabia,Yemen,Yemen,1,0,FIFA World Cup qualification,Jeddah,Saudi Arabia,1989,9,4,1,-1,1,1,winner,loser,645,4,0,1,0.78073599,0.111632613
03/04/1986,3,Iraq,Iraq,Kuwait,Kuwait,1,2,Gulf Cup,Riffa,Bahrain,1986,6,4,-1,1,1,3,loser,winner,531,4,0,0,0.38144151,0.761874863
08/12/2005,8,Iraq,Iraq,Saudi Arabia,Saudi_Arabia,2,0,Friendly,Doha,Qatar,2005,5,12,2,-2,2,2,winner,loser,1261,6,0,0,0.38617423,0.819125596
22/02/2006,22,Yemen,Yemen,Saudi Arabia,Saudi_Arabia,0,4,AFC Asian Cup qualification,Sana'a,Yemen,2006,6,2,-4,4,4,4,loser,winner,1277,6,1,0,0.33155405,0.16281587
06/04/1986,6,Oman,Oman,Iraq,Iraq,2,3,Gulf Cup,Riffa,Bahrain,1986,6,4,-1,1,1,5,loser,winner,534,4,1,0,0.35563948,0.027357377
07/04/1986,7,Bahrain,Bahrain,Kuwait,Kuwait,1,1,Gulf Cup,Riffa,Bahrain,1986,6,4,0,0,0,2,draw,draw,535,4,0,0,0.78519633,0.679398607
14/06/2006,14,Tunisia,Tunisia,Saudi Arabia,Saudi_Arabia,2,2,FIFA World Cup,Munich,Germany,2006,6,6,0,0,0,4,draw,draw,1283,6,1,0,0.97302801,0.298818344
12/08/1986,12,Bahrain,Bahrain,Oman,Oman,2,3,Friendly,Manama,Bahrain,1986,6,8,-1,1,1,5,loser,winner,537,4,0,1,0.87619948,0.473027525
14/08/1986,14,Bahrain,Bahrain,Oman,Oman,2,0,Friendly,Manama,Bahrain,1986,6,8,2,-2,2,2,winner,loser,538,4,0,1,0.28429497,0.642066059
24/08/1986,24,Oman,Oman,Bahrain,Bahrain,1,0,Friendly,Muscat,Oman,1986,6,8,1,-1,1,1,winner,loser,539,4,1,0,0.55370861,0.61399246
26/08/1986,26,Oman,Oman,Bahrain,Bahrain,1,2,Friendly,Muscat,Oman,1986,6,8,-1,1,1,3,loser,winner,540,4,1,0,0.52746107,0.151132091
16/02/1987,16,Kuwait,Kuwait,Algeria,Algeria,2,0,Friendly,Kuwait City,Kuwait,1987,7,2,2,-2,2,2,winner,loser,541,4,0,1,0.89227655,0.541382742
21/02/1987,21,Kuwait,Kuwait,Iraq,Iraq,2,0,Friendly,Kuwait City,Kuwait,1987,7,2,2,-2,2,2,winner,loser,542,4,0,0,0.98617401,0.360854509
06/11/1994,6,UAE,UAE,Saudi Arabia,Saudi_Arabia,1,1,Gulf Cup,Abu Dhabi,United Arab Emirates,1994,4,11,0,0,0,2,draw,draw,755,5,0,0,0.86372778,0.169714418
31/10/1992,31,Saudi Arabia,Saudi_Arabia,Qatar,Qatar,1,1,AFC Asian Cup,Hiroshima,Japan,1992,2,10,0,0,0,2,draw,draw,696,5,0,1,0.59225273,0.989734531
27/03/1987,27,Algeria,Algeria,Tunisia,Tunisia,1,0,African Cup of Nations qualification,Algiers,Algeria,1987,7,3,1,-1,1,1,winner,loser,545,4,1,1,0.08252995,0.249885869
08/04/1987,8,Bahrain,Bahrain,Iraq,Iraq,1,3,Friendly,Manama,Bahrain,1987,7,4,-2,2,2,4,loser,winner,546,4,0,0,0.96665332,0.86208821
10/04/1987,10,Bahrain,Bahrain,Iraq,Iraq,1,2,Friendly,Manama,Bahrain,1987,7,4,-1,1,1,3,loser,winner,547,4,0,0,0.89163598,0.545492363
07/11/1987,7,Kuwait,Kuwait,Egypt,Egypt,0,2,Friendly,Kuwait City,Kuwait,1987,7,11,-2,2,2,2,loser,winner,548,4,0,1,0.46616345,0.985060907
11/12/1987,11,Algeria,Algeria,Tunisia,Tunisia,0,0,UAFA Cup,Algiers,Algeria,1987,7,12,0,0,0,0,draw,draw,549,4,1,1,0.59447903,0.537260526
13/12/1987,13,Mauritania,Mauritania,Tunisia,Tunisia,1,2,UAFA Cup,Algiers,Algeria,1987,7,12,-1,1,1,3,loser,winner,550,4,1,1,0.31741621,0.307876879
15/12/1987,15,Algeria,Algeria,Mauritania,Mauritania,3,0,UAFA Cup,Algiers,Algeria,1987,7,12,3,-3,3,3,winner,loser,551,4,1,1,0.95374506,0.978460143
01/07/2007,1,Oman,Oman,Saudi Arabia,Saudi_Arabia,1,1,Friendly,Singapore,Singapore,2007,7,7,0,0,0,2,draw,draw,1351,6,1,0,0.87790081,0.896777648
29/07/2007,29,Iraq,Iraq,Saudi Arabia,Saudi_Arabia,1,0,AFC Asian Cup,Jakarta,Indonesia,2007,7,7,1,-1,1,1,winner,loser,1355,6,0,0,0.71777403,0.874073539
27/10/1996,27,UAE,UAE,Saudi Arabia,Saudi_Arabia,2,2,Gulf Cup,Muscat,Oman,1996,6,10,0,0,0,4,draw,draw,819,5,0,0,0.53057626,0.259436912
28/11/1992,28,Saudi Arabia,Saudi_Arabia,Bahrain,Bahrain,1,2,Gulf Cup,Doha,Qatar,1992,2,11,-1,1,1,3,loser,winner,703,5,0,0,0.09608001,0.003394278
25/02/1988,25,Djibouti,Djibouti,Yemen,Yemen,4,1,Friendly,Djibouti,Djibouti,1988,8,2,3,-3,3,5,winner,loser,556,4,0,1,0.30544996,0.778243581
25/02/1988,25,Iraq,Iraq,Tunisia,Tunisia,2,0,Friendly,Baghdad,Iraq,1988,8,2,2,-2,2,2,winner,loser,557,4,0,1,0.34364601,0.565657645
21/12/1996,21,UAE,UAE,Saudi Arabia,Saudi_Arabia,0,0,AFC Asian Cup,Abu Dhabi,United Arab Emirates,1996,6,12,0,0,0,0,draw,draw,830,5,0,0,0.14502117,0.276433485
18/05/1993,18,Saudi Arabia,Saudi_Arabia,Kuwait,Kuwait,2,0,FIFA World Cup qualification,Ta'if,Saudi Arabia,1993,3,5,2,-2,2,2,winner,loser,727,5,0,0,0.61225182,0.303732334
03/03/1988,3,Qatar,Qatar,Kuwait,Kuwait,1,1,Gulf Cup,Riyadh,Saudi Arabia,1988,8,3,0,0,0,2,draw,draw,560,4,1,0,0.31291866,0.936745942
25/06/1994,25,Saudi Arabia,Saudi_Arabia,Morocco,Morocco,2,1,FIFA World Cup,East Rutherford,United States,1994,4,6,1,-1,1,3,winner,loser,746,5,0,0,0.96010067,0.384901772
04/03/1988,4,Iraq,Iraq,Oman,Oman,1,1,Gulf Cup,Riyadh,Saudi Arabia,1988,8,3,0,0,0,2,draw,draw,562,4,0,1,0.22537455,0.093538541
23/12/2008,23,Bahrain,Bahrain,Saudi Arabia,Saudi_Arabia,1,0,Friendly,Manama,Bahrain,2008,8,12,1,-1,1,1,winner,loser,1416,6,0,0,0.29790152,0.027930202
10/11/1994,10,Saudi Arabia,Saudi_Arabia,Bahrain,Bahrain,3,1,Gulf Cup,Abu Dhabi,United Arab Emirates,1994,4,11,2,-2,2,4,winner,loser,760,5,0,0,0.97210005,0.92726063
07/03/1988,7,Oman,Oman,Bahrain,Bahrain,0,2,Gulf Cup,Riyadh,Saudi Arabia,1988,8,3,-2,2,2,2,loser,winner,565,4,1,0,0.75598693,0.768950244
08/03/1988,8,Iraq,Iraq,Kuwait,Kuwait,1,0,Gulf Cup,Riyadh,Saudi Arabia,1988,8,3,1,-1,1,1,winner,loser,566,4,0,0,0.74348523,0.311000506
14/01/2009,14,Kuwait,Kuwait,Saudi Arabia,Saudi_Arabia,0,1,Gulf Cup,Muscat,Oman,2009,9,1,-1,1,1,1,loser,winner,1435,6,0,0,0.35175794,0.906747445
28/01/1996,28,Saudi Arabia,Saudi_Arabia,Yemen,Yemen,4,0,AFC Asian Cup qualification,Riyadh,Saudi Arabia,1996,6,1,4,-4,4,4,winner,loser,785,5,0,1,0.25713247,0.226613702
10/03/1988,10,Oman,Oman,Qatar,Qatar,2,1,Gulf Cup,Riyadh,Saudi Arabia,1988,8,3,1,-1,1,3,winner,loser,569,4,1,1,0.27690196,0.010654605
04/02/1996,4,Saudi Arabia,Saudi_Arabia,Yemen,Yemen,1,0,AFC Asian Cup qualification,Riyadh,Saudi Arabia,1996,6,2,1,-1,1,1,winner,loser,786,5,0,1,0.70299395,0.687518197
12/03/1988,12,Kuwait,Kuwait,Bahrain,Bahrain,0,1,Gulf Cup,Riyadh,Saudi Arabia,1988,8,3,-1,1,1,1,loser,winner,571,4,0,0,0.90678333,0.548340771
13/03/1988,13,Qatar,Qatar,Iraq,Iraq,0,3,Gulf Cup,Riyadh,Saudi Arabia,1988,8,3,-3,3,3,3,loser,winner,572,4,1,0,0.32642556,0.539316171
21/10/1996,21,Saudi Arabia,Saudi_Arabia,Bahrain,Bahrain,3,1,Gulf Cup,Muscat,Oman,1996,6,10,2,-2,2,4,winner,loser,814,5,0,0,0.70981311,0.448401874
14/03/1988,14,Oman,Oman,Kuwait,Kuwait,0,2,Gulf Cup,Riyadh,Saudi Arabia,1988,8,3,-2,2,2,2,loser,winner,574,4,1,0,0.34453921,0.941982233
16/03/1988,16,Bahrain,Bahrain,Qatar,Qatar,1,0,Gulf Cup,Riyadh,Saudi Arabia,1988,8,3,1,-1,1,1,winner,loser,575,4,0,1,0.05392398,0.685194225
16/03/1988,16,Morocco,Morocco,Algeria,Algeria,1,0,African Cup of Nations,Casablanca,Morocco,1988,8,3,1,-1,1,1,winner,loser,576,4,0,1,0.75654439,0.306543102
16/11/1996,16,Saudi Arabia,Saudi_Arabia,Syria,Syria,3,1,Friendly,Jeddah,Saudi Arabia,1996,6,11,2,-2,2,4,winner,loser,822,5,0,0,0.38830314,0.026734447
08/12/1996,8,Saudi Arabia,Saudi_Arabia,Iraq,Iraq,1,0,AFC Asian Cup,Dubai,United Arab Emirates,1996,6,12,1,-1,1,1,winner,loser,827,5,0,0,0.63494289,0.645547504
18/03/1988,18,Bahrain,Bahrain,Iraq,Iraq,0,1,Gulf Cup,Riyadh,Saudi Arabia,1988,8,3,-1,1,1,1,loser,winner,579,4,0,0,0.19721265,0.664485789
02/03/1997,2,Saudi Arabia,Saudi_Arabia,Syria,Syria,3,0,Friendly,Riyadh,Saudi Arabia,1997,7,3,3,-3,3,3,winner,loser,839,5,0,0,0.78965103,0.578327966
26/03/1988,26,Morocco,Morocco,Algeria,Algeria,1,1,African Cup of Nations,Casablanca,Morocco,1988,8,3,0,0,0,2,draw,draw,581,4,0,1,0.74616549,0.859153121
12/04/1988,12,Kuwait,Kuwait,Jordan,Jordan,0,0,AFC Asian Cup qualification,Kuala Lumpur,Malaysia,1988,8,4,0,0,0,0,draw,draw,582,4,0,1,0.30448472,0.59635815
22/06/1988,22,Bahrain,Bahrain,Yemen,Yemen,2,0,AFC Asian Cup qualification,Jakarta,Indonesia,1988,8,6,2,-2,2,2,winner,loser,583,4,0,1,0.42370704,0.203067569
08/07/1988,8,Algeria,Algeria,Syria,Syria,1,1,UAFA Cup,Amman,Jordan,1988,8,7,0,0,0,2,draw,draw,584,4,1,0,0.59406371,0.530621076
08/07/1988,8,Jordan,Jordan,Bahrain,Bahrain,0,0,UAFA Cup,Amman,Jordan,1988,8,7,0,0,0,0,draw,draw,585,4,1,0,0.78514358,0.770038492
17/01/2009,17,Oman,Oman,Saudi Arabia,Saudi_Arabia,0,0,Gulf Cup,Muscat,Oman,2009,9,1,0,0,0,0,draw,draw,1437,6,1,0,0.07781323,0.288456801
09/07/1988,9,Iraq,Iraq,Tunisia,Tunisia,1,1,UAFA Cup,Amman,Jordan,1988,8,7,0,0,0,2,draw,draw,587,4,0,1,0.52368272,0.331446321
10/07/1988,10,Algeria,Algeria,Bahrain,Bahrain,0,0,UAFA Cup,Amman,Jordan,1988,8,7,0,0,0,0,draw,draw,588,4,1,0,0.57371864,0.236036017
10/07/1988,10,Jordan,Jordan,Kuwait,Kuwait,0,1,UAFA Cup,Amman,Jordan,1988,8,7,-1,1,1,1,loser,winner,589,4,1,0,0.21373513,0.830699773
11/07/1988,11,Iraq,Iraq,Lebanon,Lebanon,0,0,UAFA Cup,Amman,Jordan,1988,8,7,0,0,0,0,draw,draw,590,4,0,1,0.76281717,0.12174925
14/09/1997,14,Saudi Arabia,Saudi_Arabia,Kuwait,Kuwait,2,1,FIFA World Cup qualification,Ta'if,Saudi Arabia,1997,7,9,1,-1,1,3,winner,loser,858,5,0,0,0.3991498,0.022174216
12/07/1988,12,Algeria,Algeria,Kuwait,Kuwait,1,0,UAFA Cup,Amman,Jordan,1988,8,7,1,-1,1,1,winner,loser,592,4,1,0,0.34659121,0.926362899
12/07/1988,12,Bahrain,Bahrain,Syria,Syria,1,2,UAFA Cup,Amman,Jordan,1988,8,7,-1,1,1,3,loser,winner,593,4,0,0,0.09259231,0.811397214
13/07/1988,13,Egypt,Egypt,Tunisia,Tunisia,1,0,UAFA Cup,Amman,Jordan,1988,8,7,1,-1,1,1,winner,loser,594,4,1,1,0.32063393,0.917059561
26/05/2009,26,Qatar,Qatar,Saudi Arabia,Saudi_Arabia,2,1,Friendly,Doha,Qatar,2009,9,5,1,-1,1,3,winner,loser,1446,6,1,0,0.51359151,0.537179238
14/07/1988,14,Jordan,Jordan,Algeria,Algeria,2,1,UAFA Cup,Amman,Jordan,1988,8,7,1,-1,1,3,winner,loser,596,4,1,1,0.70299504,0.404212205
14/07/1988,14,Kuwait,Kuwait,Syria,Syria,0,1,UAFA Cup,Amman,Jordan,1988,8,7,-1,1,1,1,loser,winner,597,4,0,0,0.02818393,0.689035267
15/07/1988,15,Egypt,Egypt,Lebanon,Lebanon,3,0,UAFA Cup,Amman,Jordan,1988,8,7,3,-3,3,3,winner,loser,598,4,1,1,0.62076434,0.885971705
12/08/2009,12,Oman,Oman,Saudi Arabia,Saudi_Arabia,2,1,Friendly,Salalah,Oman,2009,9,8,1,-1,1,3,winner,loser,1453,6,1,0,0.43308497,0.440965739
16/07/1988,16,Bahrain,Bahrain,Kuwait,Kuwait,1,1,UAFA Cup,Amman,Jordan,1988,8,7,0,0,0,2,draw,draw,600,4,0,0,0.68889158,0.542003608
16/07/1988,16,Jordan,Jordan,Syria,Syria,2,0,UAFA Cup,Amman,Jordan,1988,8,7,2,-2,2,2,winner,loser,601,4,1,0,0.50605249,0.666697256
17/07/1988,17,Egypt,Egypt,Iraq,Iraq,0,0,UAFA Cup,Amman,Jordan,1988,8,7,0,0,0,0,draw,draw,602,4,1,0,0.85904025,0.95455647
17/07/1988,17,Lebanon,Lebanon,Tunisia,Tunisia,1,1,UAFA Cup,Amman,Jordan,1988,8,7,0,0,0,2,draw,draw,603,4,1,1,0.13012238,0.297048157
19/07/1988,19,Egypt,Egypt,Syria,Syria,0,0,UAFA Cup,Amman,Jordan,1988,8,7,0,0,0,0,draw,draw,604,4,1,0,0.45876968,0.616529927
19/07/1988,19,Jordan,Jordan,Iraq,Iraq,0,3,UAFA Cup,Amman,Jordan,1988,8,7,-3,3,3,3,loser,winner,605,4,1,0,0.1428988,0.14669895
21/07/1988,21,Iraq,Iraq,Syria,Syria,1,1,UAFA Cup,Amman,Jordan,1988,8,7,0,0,0,2,draw,draw,606,4,0,0,0.94143337,0.732955901
21/07/1988,21,Jordan,Jordan,Egypt,Egypt,0,2,UAFA Cup,Amman,Jordan,1988,8,7,-2,2,2,2,loser,winner,607,4,1,1,0.87531978,0.045108436
11/10/1997,11,Saudi Arabia,Saudi_Arabia,Qatar,Qatar,1,0,FIFA World Cup qualification,Ta'if,Saudi Arabia,1997,7,10,1,-1,1,1,winner,loser,862,5,0,1,0.9716854,0.894889031
16/11/1988,16,Kuwait,Kuwait,Egypt,Egypt,2,2,Friendly,Kuwait City,Kuwait,1988,8,11,0,0,0,4,draw,draw,609,4,0,1,0.26996644,0.970694332
14/09/1998,14,Saudi Arabia,Saudi_Arabia,Sudan,Sudan,2,1,Friendly,Dammam,Saudi Arabia,1998,8,9,1,-1,1,3,winner,loser,881,5,0,1,0.36241995,0.546787659
27/09/1998,27,Saudi Arabia,Saudi_Arabia,Lebanon,Lebanon,4,1,UAFA Cup,Doha,Qatar,1998,8,9,3,-3,3,5,winner,loser,890,5,0,1,0.77822665,0.784856391
29/09/1998,29,Saudi Arabia,Saudi_Arabia,Kuwait,Kuwait,2,1,UAFA Cup,Doha,Qatar,1998,8,9,1,-1,1,3,winner,loser,893,5,0,0,0.92439788,0.915826982
05/09/2009,5,Bahrain,Bahrain,Saudi Arabia,Saudi_Arabia,0,0,FIFA World Cup qualification,Riffa,Bahrain,2009,9,9,0,0,0,0,draw,draw,1455,6,0,0,0.2258493,0.921596357
08/08/2001,8,UAE,UAE,Saudi Arabia,Saudi_Arabia,0,1,Friendly,Doha,Qatar,2001,1,8,-1,1,1,1,loser,winner,1018,6,0,0,0.97946407,0.897747834
03/12/1988,3,Kuwait,Kuwait,Bahrain,Bahrain,0,0,AFC Asian Cup,Doha,Qatar,1988,8,12,0,0,0,0,draw,draw,615,4,0,0,0.81897931,0.127958595
14/10/2009,14,Tunisia,Tunisia,Saudi Arabia,Saudi_Arabia,0,1,Friendly,Radès,Tunisia,2009,9,10,-1,1,1,1,loser,winner,1461,6,1,0,0.45918627,0.673663277
18/06/1999,18,Saudi Arabia,Saudi_Arabia,Jordan,Jordan,2,1,Friendly,Riyadh,Saudi Arabia,1999,9,6,1,-1,1,3,winner,loser,920,5,0,1,0.84985761,0.231613552
06/12/1988,6,Morocco,Morocco,Egypt,Egypt,0,0,Friendly,Casablanca,Morocco,1988,8,12,0,0,0,0,draw,draw,618,4,0,1,0.00469383,0.193383848
08/12/1988,8,Syria,Syria,Kuwait,Kuwait,1,0,AFC Asian Cup,Doha,Qatar,1988,8,12,1,-1,1,1,winner,loser,619,4,0,0,0.33504766,0.135109992
22/06/1999,22,Saudi Arabia,Saudi_Arabia,Jordan,Jordan,2,0,Friendly,Riyadh,Saudi Arabia,1999,9,6,2,-2,2,2,winner,loser,921,5,0,1,0.85450803,0.055458837
11/12/1988,11,Bahrain,Bahrain,Syria,Syria,0,1,AFC Asian Cup,Doha,Qatar,1988,8,12,-1,1,1,1,loser,winner,621,4,0,0,0.25193599,0.057367414
06/01/1989,6,Oman,Oman,Iraq,Iraq,1,1,FIFA World Cup qualification,Muscat,Oman,1989,9,1,0,0,0,2,draw,draw,622,4,1,0,0.36180698,0.231636915
06/01/1989,6,Qatar,Qatar,Jordan,Jordan,1,0,FIFA World Cup qualification,Doha,Qatar,1989,9,1,1,-1,1,1,winner,loser,623,4,1,1,0.88398133,0.786904029
13/01/1989,13,Jordan,Jordan,Iraq,Iraq,0,1,FIFA World Cup qualification,Amman,Jordan,1989,9,1,-1,1,1,1,loser,winner,624,4,1,0,0.96332438,0.148397988
22/11/2010,22,Yemen,Yemen,Saudi Arabia,Saudi_Arabia,0,4,Gulf Cup,Aden,Yemen,2010,0,11,-4,4,4,4,loser,winner,1501,7,1,0,0.34524037,0.874005531
13/01/1989,13,Oman,Oman,Qatar,Qatar,0,0,FIFA World Cup qualification,Muscat,Oman,1989,9,1,0,0,0,0,draw,draw,626,4,1,1,0.80934447,0.758331083
20/01/1989,20,Jordan,Jordan,Oman,Oman,2,0,FIFA World Cup qualification,Amman,Jordan,1989,9,1,2,-2,2,2,winner,loser,627,4,1,1,0.89561959,0.284529332
20/01/1989,20,Qatar,Qatar,Iraq,Iraq,1,0,FIFA World Cup qualification,Doha,Qatar,1989,9,1,1,-1,1,1,winner,loser,628,4,1,0,0.28199828,0.914110234
22/01/1989,22,Tunisia,Tunisia,Morocco,Morocco,2,1,FIFA World Cup qualification,Tunis,Tunisia,1989,9,1,1,-1,1,3,winner,loser,629,4,1,0,0.09169942,0.769871883
27/01/1989,27,Iraq,Iraq,Oman,Oman,3,1,FIFA World Cup qualification,Baghdad,Iraq,1989,9,1,2,-2,2,4,winner,loser,630,4,0,1,0.17683097,0.249643236
27/01/1989,27,Jordan,Jordan,Qatar,Qatar,1,1,FIFA World Cup qualification,Amman,Jordan,1989,9,1,0,0,0,2,draw,draw,631,4,1,1,0.34679942,0.08571061
03/02/1989,3,Iraq,Iraq,Jordan,Jordan,4,0,FIFA World Cup qualification,Baghdad,Iraq,1989,9,2,4,-4,4,4,winner,loser,632,4,0,1,0.79911549,0.034258764
03/02/1989,3,Qatar,Qatar,Oman,Oman,3,0,FIFA World Cup qualification,Doha,Qatar,1989,9,2,3,-3,3,3,winner,loser,633,4,1,1,0.99192038,0.303181053
24/09/2000,24,Saudi Arabia,Saudi_Arabia,Syria,Syria,2,1,Friendly,Abha,Saudi Arabia,2000,0,9,1,-1,1,3,winner,loser,970,6,0,0,0.83466492,0.315407043
10/02/1989,10,Iraq,Iraq,Qatar,Qatar,2,2,FIFA World Cup qualification,Baghdad,Iraq,1989,9,2,0,0,0,4,draw,draw,635,4,0,1,0.86220371,0.288261436
10/02/1989,10,Oman,Oman,Jordan,Jordan,0,2,FIFA World Cup qualification,Muscat,Oman,1989,9,2,-2,2,2,2,loser,winner,636,4,1,1,0.02475895,0.670305254
10/03/1989,10,Yemen,Yemen,Syria,Syria,0,1,FIFA World Cup qualification,Sana'a,Yemen AR,1989,9,3,-1,1,1,1,loser,winner,637,4,1,0,0.18804372,0.83713043
26/09/2000,26,Saudi Arabia,Saudi_Arabia,Syria,Syria,3,0,Friendly,Abha,Saudi Arabia,2000,0,9,3,-3,3,3,winner,loser,971,6,0,0,0.26604342,0.355102169
15/03/1989,15,Tunisia,Tunisia,Egypt,Egypt,0,0,Friendly,Tunis,Tunisia,1989,9,3,0,0,0,0,draw,draw,639,4,1,1,0.2506277,0.421256088
28/11/2010,28,Qatar,Qatar,Saudi Arabia,Saudi_Arabia,1,1,Gulf Cup,Aden,Yemen,2010,0,11,0,0,0,2,draw,draw,1508,7,1,0,0.23886425,0.520386247
22/03/1989,22,Algeria,Algeria,Morocco,Morocco,1,1,Friendly,Bejaia,Algeria,1989,9,3,0,0,0,2,draw,draw,641,4,1,0,0.37515846,0.541524504
25/03/1989,25,Syria,Syria,Yemen,Yemen,2,0,FIFA World Cup qualification,Latakia,Syria,1989,9,3,2,-2,2,2,winner,loser,642,4,0,1,0.28221352,0.677601252
26/12/2003,26,UAE,UAE,Saudi Arabia,Saudi_Arabia,0,2,Gulf Cup,Kuwait City,Kuwait,2003,3,12,-2,2,2,2,loser,winner,1133,6,0,0,0.90137514,0.978940735
04/04/1989,4,Algeria,Algeria,Tunisia,Tunisia,2,0,Friendly,Algiers,Algeria,1989,9,4,2,-2,2,2,winner,loser,644,4,1,1,0.33473173,0.355877736
05/12/2010,5,Kuwait,Kuwait,Saudi Arabia,Saudi_Arabia,1,0,Gulf Cup,Aden,Yemen,2010,0,12,1,-1,1,1,winner,loser,1514,7,0,0,0.01882442,0.862685649
24/05/1989,24,Morocco,Morocco,Algeria,Algeria,1,0,Friendly,Rabat,Morocco,1989,9,5,1,-1,1,1,winner,loser,646,4,0,1,0.47307184,0.680116347
26/07/1989,26,Algeria,Algeria,Qatar,Qatar,1,1,Friendly,Tlemcen,Algeria,1989,9,7,0,0,0,2,draw,draw,647,4,1,1,0.48850595,0.674310376
13/08/1989,13,Morocco,Morocco,Tunisia,Tunisia,0,0,FIFA World Cup qualification,Casablanca,Morocco,1989,9,8,0,0,0,0,draw,draw,648,4,0,1,0.81686518,0.283167651
22/09/1989,22,Kuwait,Kuwait,Qatar,Qatar,1,0,Friendly,Kuwait City,Kuwait,1989,9,9,1,-1,1,1,winner,loser,649,4,0,1,0.49086884,0.427418484
25/09/1989,25,Kuwait,Kuwait,Egypt,Egypt,0,0,Friendly,Kuwait City,Kuwait,1989,9,9,0,0,0,0,draw,draw,650,4,0,1,0.36383855,0.109743104
08/10/1989,8,Algeria,Algeria,Egypt,Egypt,0,0,FIFA World Cup qualification,Constantine,Algeria,1989,9,10,0,0,0,0,draw,draw,651,4,1,1,0.98178545,0.800852238
15/10/1989,15,Iraq,Iraq,Kuwait,Kuwait,1,0,Friendly,Baghdad,Iraq,1989,9,10,1,-1,1,1,winner,loser,652,4,0,0,0.13027005,0.705808965
13/01/2011,13,Jordan,Jordan,Saudi Arabia,Saudi_Arabia,1,0,AFC Asian Cup,Rayyan,Qatar,2011,1,1,1,-1,1,1,winner,loser,1522,7,1,0,0.82316036,0.319048529
17/10/2000,17,Saudi Arabia,Saudi_Arabia,Qatar,Qatar,0,0,AFC Asian Cup,Sidon,Lebanon,2000,0,10,0,0,0,0,draw,draw,978,6,0,1,0.86585904,0.94957309
30/01/2001,30,Saudi Arabia,Saudi_Arabia,Syria,Syria,1,0,Friendly,Dammam,Saudi Arabia,2001,1,1,1,-1,1,1,winner,loser,991,6,0,0,0.0078038,0.209466552
30/10/1989,30,Kuwait,Kuwait,Lebanon,Lebanon,5,0,Friendly,Kuwait City,Kuwait,1989,9,10,5,-5,5,5,winner,loser,656,4,0,1,0.63622368,0.586644847
01/11/1989,1,Tunisia,Tunisia,Algeria,Algeria,0,0,Friendly,Tunis,Tunisia,1989,9,11,0,0,0,0,draw,draw,657,4,1,1,0.34658481,0.596950068
03/11/1989,3,Iraq,Iraq,Yemen,Yemen,6,2,Friendly,Kuwait City,Kuwait,1989,9,11,4,-4,4,8,winner,loser,658,4,0,1,0.62482942,0.657015511
03/11/1989,3,Qatar,Qatar,Egypt,Egypt,0,2,Friendly,Doha,Qatar,1989,9,11,-2,2,2,2,loser,winner,659,4,1,1,0.78752783,0.294462719
08/11/1989,8,Kuwait,Kuwait,Iraq,Iraq,1,2,Friendly,Kuwait City,Kuwait,1989,9,11,-1,1,1,3,loser,winner,660,4,0,0,0.45069261,0.655963373
17/11/1989,17,Egypt,Egypt,Algeria,Algeria,1,0,FIFA World Cup qualification,Cairo,Egypt,1989,9,11,1,-1,1,1,winner,loser,661,4,1,1,0.20180291,0.704345331
05/08/2001,5,Saudi Arabia,Saudi_Arabia,Qatar,Qatar,1,2,Friendly,Riyadh,Saudi Arabia,2001,1,8,-1,1,1,3,loser,winner,1017,6,0,1,0.22989155,0.980977137
17/08/2001,17,Saudi Arabia,Saudi_Arabia,Bahrain,Bahrain,1,1,FIFA World Cup qualification,Riyadh,Saudi Arabia,2001,1,8,0,0,0,2,draw,draw,1021,6,0,0,0.23354352,0.827785618
21/02/1990,21,Kuwait,Kuwait,Bahrain,Bahrain,1,0,Gulf Cup,Kuwait City,Kuwait,1990,0,2,1,-1,1,1,winner,loser,664,5,0,0,0.06010027,0.675116371
13/07/2011,13,Jordan,Jordan,Saudi Arabia,Saudi_Arabia,1,1,Friendly,Amman,Jordan,2011,1,7,0,0,0,2,draw,draw,1540,7,1,0,0.13253455,0.507369895
23/02/1990,23,Qatar,Qatar,Bahrain,Bahrain,0,0,Gulf Cup,Kuwait City,Kuwait,1990,0,2,0,0,0,0,draw,draw,666,5,1,0,0.52101803,0.687919468
24/02/1990,24,Kuwait,Kuwait,Oman,Oman,1,1,Gulf Cup,Kuwait City,Kuwait,1990,0,2,0,0,0,2,draw,draw,667,5,0,1,0.45433997,0.73431083
16/07/2011,16,Kuwait,Kuwait,Saudi Arabia,Saudi_Arabia,1,0,Friendly,Amman,Jordan,2011,1,7,1,-1,1,1,winner,loser,1543,7,0,0,0.46128509,0.579094618
01/03/1990,1,Bahrain,Bahrain,Oman,Oman,0,0,Gulf Cup,Kuwait City,Kuwait,1990,0,3,0,0,0,0,draw,draw,669,5,0,1,0.20444272,0.236170339
04/03/1990,4,Oman,Oman,Qatar,Qatar,2,4,Gulf Cup,Kuwait City,Kuwait,1990,0,3,-2,2,2,6,loser,winner,670,5,1,1,0.14376611,0.414631954
02/09/2011,2,Oman,Oman,Saudi Arabia,Saudi_Arabia,0,0,FIFA World Cup qualification,Muscat,Oman,2011,1,9,0,0,0,0,draw,draw,1556,7,1,0,0.61998993,0.504290846
07/03/1990,7,Kuwait,Kuwait,Qatar,Qatar,2,0,Gulf Cup,Kuwait City,Kuwait,1990,0,3,2,-2,2,2,winner,loser,672,5,0,1,0.86186871,0.412886087
08/03/1990,8,Algeria,Algeria,Egypt,Egypt,2,0,African Cup of Nations,Algiers,Algeria,1990,0,3,2,-2,2,2,winner,loser,673,5,1,1,0.95605375,0.505704648
27/01/2007,27,UAE,UAE,Saudi Arabia,Saudi_Arabia,1,0,Gulf Cup,Abu Dhabi,United Arab Emirates,2007,7,1,1,-1,1,1,winner,loser,1334,6,0,0,0.77372324,0.170773357
01/06/1990,1,Jordan,Jordan,Iraq,Iraq,0,2,Friendly,Amman,Jordan,1990,0,6,-2,2,2,2,loser,winner,675,5,1,0,0.29627449,0.396520366
09/08/1990,9,Tunisia,Tunisia,Morocco,Morocco,0,0,Friendly,Tunis,Tunisia,1990,0,8,0,0,0,0,draw,draw,676,5,1,0,0.75355379,0.882626738
02/09/1990,2,Morocco,Morocco,Mauritania,Mauritania,4,0,African Cup of Nations qualification,Casablanca,Morocco,1990,0,9,4,-4,4,4,winner,loser,677,5,0,1,0.89342886,0.241637426
05/03/1991,5,Algeria,Algeria,Tunisia,Tunisia,2,1,Friendly,Annaba,Algeria,1991,1,3,1,-1,1,3,winner,loser,678,5,1,1,0.72715845,0.139176031
03/04/1991,3,Algeria,Algeria,Morocco,Morocco,2,2,Friendly,Annaba,Algeria,1991,1,4,0,0,0,4,draw,draw,679,5,1,0,0.74427515,0.850273392
07/04/1991,7,Tunisia,Tunisia,Algeria,Algeria,0,0,Friendly,Tunis,Tunisia,1991,1,4,0,0,0,0,draw,draw,680,5,1,1,0.47416539,0.92226797
12/04/1991,12,Mauritania,Mauritania,Morocco,Morocco,0,2,African Cup of Nations qualification,Nouakchott,Mauritania,1991,1,4,-2,2,2,2,loser,winner,681,5,1,0,0.38425139,0.943398533
14/04/1991,14,Tunisia,Tunisia,Egypt,Egypt,2,2,African Cup of Nations qualification,Tunis,Tunisia,1991,1,4,0,0,0,4,draw,draw,682,5,1,1,0.19877258,0.009104615
26/07/1991,26,Egypt,Egypt,Tunisia,Tunisia,2,2,African Cup of Nations qualification,Cairo,Egypt,1991,1,7,0,0,0,4,draw,draw,683,5,1,1,0.40878791,0.053575503
26/12/1991,26,Morocco,Morocco,Algeria,Algeria,1,1,Friendly,Casablanca,Morocco,1991,1,12,0,0,0,2,draw,draw,684,5,0,1,0.1737599,0.10517995
14/05/1992,14,Kuwait,Kuwait,Syria,Syria,0,0,Friendly,Kuwait City,Kuwait,1992,2,5,0,0,0,0,draw,draw,685,5,0,0,0.36882789,0.713227772
31/08/2001,31,Saudi Arabia,Saudi_Arabia,Iraq,Iraq,1,0,FIFA World Cup qualification,Riffa,Bahrain,2001,1,8,1,-1,1,1,winner,loser,1023,6,0,0,0.7993574,0.882414588
17/05/1992,17,Qatar,Qatar,Kuwait,Kuwait,0,0,Friendly,Doha,Qatar,1992,2,5,0,0,0,0,draw,draw,687,5,1,0,0.03592229,0.73346899
12/12/2012,12,Yemen,Yemen,Saudi Arabia,Saudi_Arabia,0,1,WAFF Championship,al-Farwaniyah,Kuwait,2012,2,12,-1,1,1,1,loser,winner,1628,7,1,0,0.38184912,0.299998367
19/05/1992,19,Bahrain,Bahrain,Algeria,Algeria,0,0,Friendly,Manama,Bahrain,1992,2,5,0,0,0,0,draw,draw,689,5,0,1,0.59056094,0.991483348
16/01/2002,16,Saudi Arabia,Saudi_Arabia,Kuwait,Kuwait,1,1,Gulf Cup,Riyadh,Saudi Arabia,2002,2,1,0,0,0,2,draw,draw,1045,6,0,0,0.70990135,0.708493765
29/05/1992,29,Qatar,Qatar,Syria,Syria,4,2,AFC Asian Cup qualification,Doha,Qatar,1992,2,5,2,-2,2,6,winner,loser,691,5,1,0,0.51987561,0.990188183
31/05/1992,31,Qatar,Qatar,Oman,Oman,4,0,AFC Asian Cup qualification,Doha,Qatar,1992,2,5,4,-4,4,4,winner,loser,692,5,1,1,0.03562606,0.596405332
18/08/1992,18,Jordan,Jordan,Sudan,Sudan,3,0,Jordan International Tournament,Amman,Jordan,1992,2,8,3,-3,3,3,winner,loser,693,5,1,1,0.76169256,0.802150891
28/08/1992,28,Jordan,Jordan,Iraq,Iraq,2,0,Jordan International Tournament,Amman,Jordan,1992,2,8,2,-2,2,2,winner,loser,694,5,1,0,0.17882567,0.825385176
22/10/1992,22,Kuwait,Kuwait,Oman,Oman,4,0,Friendly,Kuwait City,Kuwait,1992,2,10,4,-4,4,4,winner,loser,695,5,0,1,0.10332264,0.004866879
20/01/2002,20,Saudi Arabia,Saudi_Arabia,Bahrain,Bahrain,3,1,Gulf Cup,Riyadh,Saudi Arabia,2002,2,1,2,-2,2,4,winner,loser,1049,6,0,0,0.26364728,0.075791323
02/11/1992,2,Egypt,Egypt,Kuwait,Kuwait,1,1,Friendly,Cairo,Egypt,1992,2,11,0,0,0,2,draw,draw,697,5,1,0,0.91309913,0.520867049
15/12/2012,15,Bahrain,Bahrain,Saudi Arabia,Saudi_Arabia,1,0,WAFF Championship,al-Farwaniyah,Kuwait,2012,2,12,1,-1,1,1,winner,loser,1632,7,0,0,0.51806168,0.587396823
08/11/1992,8,Morocco,Morocco,Egypt,Egypt,0,0,African Cup of Nations qualification,Casablanca,Morocco,1992,2,11,0,0,0,0,draw,draw,699,5,0,1,0.42216788,0.78846278
20/11/1992,20,Egypt,Egypt,Kuwait,Kuwait,1,1,Friendly,Cairo,Egypt,1992,2,11,0,0,0,2,draw,draw,700,5,1,0,0.70156645,0.021738704
24/06/2007,24,UAE,UAE,Saudi Arabia,Saudi_Arabia,0,2,Friendly,Singapore,Singapore,2007,7,6,-2,2,2,2,loser,winner,1349,6,0,0,0.66460031,0.672286389
27/11/1992,27,Qatar,Qatar,Oman,Oman,2,0,Gulf Cup,Doha,Qatar,1992,2,11,2,-2,2,2,winner,loser,702,5,1,1,0.59784213,0.903395107
27/01/2002,27,Saudi Arabia,Saudi_Arabia,Oman,Oman,2,0,Gulf Cup,Riyadh,Saudi Arabia,2002,2,1,2,-2,2,2,winner,loser,1057,6,0,1,0.66051249,0.407391358
30/01/2002,30,Saudi Arabia,Saudi_Arabia,Qatar,Qatar,3,1,Gulf Cup,Riyadh,Saudi Arabia,2002,2,1,2,-2,2,4,winner,loser,1060,6,0,1,0.6233337,0.398908514
30/11/1992,30,Kuwait,Kuwait,Oman,Oman,2,1,Gulf Cup,Doha,Qatar,1992,2,11,1,-1,1,3,winner,loser,705,5,0,1,0.12329309,0.415370432
13/12/2002,13,Saudi Arabia,Saudi_Arabia,Lebanon,Lebanon,1,1,Friendly,Dammam,Saudi Arabia,2002,2,12,0,0,0,2,draw,draw,1079,6,0,1,0.42047913,0.509672078
01/12/1992,1,Qatar,Qatar,Bahrain,Bahrain,1,0,Gulf Cup,Doha,Qatar,1992,2,12,1,-1,1,1,winner,loser,707,5,1,0,0.65693588,0.217749563
03/12/1992,3,Qatar,Qatar,Kuwait,Kuwait,4,0,Gulf Cup,Doha,Qatar,1992,2,12,4,-4,4,4,winner,loser,708,5,1,0,0.99731974,0.762167169
09/01/2013,9,Yemen,Yemen,Saudi Arabia,Saudi_Arabia,0,2,Gulf Cup,Isa Town,Bahrain,2013,3,1,-2,2,2,2,loser,winner,1649,7,1,0,0.53383949,0.760949817
12/01/2013,12,Kuwait,Kuwait,Saudi Arabia,Saudi_Arabia,1,0,Gulf Cup,Riffa,Bahrain,2013,3,1,1,-1,1,1,winner,loser,1653,7,0,0,0.6608686,0.86076463
15/10/2013,15,Iraq,Iraq,Saudi Arabia,Saudi_Arabia,0,2,AFC Asian Cup qualification,Amman,Jordan,2013,3,10,-2,2,2,2,loser,winner,1685,7,0,0,0.49686226,0.549376016
28/12/2013,28,Palestine,Palestine,Saudi Arabia,Saudi_Arabia,0,0,WAFF Championship,Doha,Qatar,2013,3,12,0,0,0,0,draw,draw,1699,7,0,0,0.94581401,0.239997339
07/12/1992,7,Bahrain,Bahrain,Oman,Oman,3,0,Gulf Cup,Doha,Qatar,1992,2,12,3,-3,3,3,winner,loser,713,5,0,1,0.09205131,0.226682456
31/12/2013,31,Qatar,Qatar,Saudi Arabia,Saudi_Arabia,4,1,WAFF Championship,Doha,Qatar,2013,3,12,3,-3,3,5,winner,loser,1702,7,1,0,0.49445357,0.247202512
10/12/1992,10,Kuwait,Kuwait,Bahrain,Bahrain,0,1,Gulf Cup,Doha,Qatar,1992,2,12,-1,1,1,1,loser,winner,715,5,0,0,0.18769817,0.027565817
10/09/2008,10,UAE,UAE,Saudi Arabia,Saudi_Arabia,1,2,FIFA World Cup qualification,Abu Dhabi,United Arab Emirates,2008,8,9,-1,1,1,3,loser,winner,1411,6,0,0,0.48818828,0.771463862
20/12/1992,20,Tunisia,Tunisia,Morocco,Morocco,1,1,FIFA World Cup qualification,Tunis,Tunisia,1992,2,12,0,0,0,2,draw,draw,717,5,1,0,0.39739963,0.985972459
02/01/1993,2,Kuwait,Kuwait,Lebanon,Lebanon,2,0,Friendly,Kuwait City,Kuwait,1993,3,1,2,-2,2,2,winner,loser,718,5,0,1,0.98133683,0.916142694
28/02/1993,28,Morocco,Morocco,Tunisia,Tunisia,0,0,FIFA World Cup qualification,Casablanca,Morocco,1993,3,2,0,0,0,0,draw,draw,719,5,0,1,0.27822728,0.332896068
02/03/1993,2,Jordan,Jordan,Syria,Syria,1,1,Friendly,Irbid,Jordan,1993,3,3,0,0,0,2,draw,draw,720,5,1,0,0.74649452,0.505055185
12/03/1993,12,Qatar,Qatar,Jordan,Jordan,1,2,Friendly,Doha,Qatar,1993,3,3,-1,1,1,3,loser,winner,721,5,1,1,0.18614208,0.458451637
16/03/1993,16,Kuwait,Kuwait,Syria,Syria,2,1,Friendly,Kuwait City,Kuwait,1993,3,3,1,-1,1,3,winner,loser,722,5,0,0,0.80822116,0.187244752
26/03/1993,26,Lebanon,Lebanon,Jordan,Jordan,1,0,Friendly,Beirut,Lebanon,1993,3,3,1,-1,1,1,winner,loser,723,5,1,1,0.87851741,0.402432881
04/04/1993,4,Kuwait,Kuwait,Egypt,Egypt,1,3,Friendly,Kuwait City,Kuwait,1993,3,4,-2,2,2,4,loser,winner,724,5,0,1,0.38550486,0.788004386
11/01/2009,11,UAE,UAE,Saudi Arabia,Saudi_Arabia,0,3,Gulf Cup,Muscat,Oman,2009,9,1,-3,3,3,3,loser,winner,1434,6,0,0,0.15898816,0.181821255
13/05/1993,13,Lebanon,Lebanon,Bahrain,Bahrain,0,0,FIFA World Cup qualification,Beirut,Lebanon,1993,3,5,0,0,0,0,draw,draw,726,5,1,0,0.2481117,0.135561923
17/12/2002,17,Saudi Arabia,Saudi_Arabia,Bahrain,Bahrain,2,1,UAFA Cup,Kuwait City,Kuwait,2002,2,12,1,-1,1,3,winner,loser,1082,6,0,0,0.44687282,0.328861471
22/05/1993,22,Jordan,Jordan,Yemen,Yemen,1,1,FIFA World Cup qualification,Irbid,Jordan,1993,3,5,0,0,0,2,draw,draw,728,5,1,1,0.21390135,0.065814186
24/05/1993,24,Jordan,Jordan,Iraq,Iraq,1,1,FIFA World Cup qualification,Irbid,Jordan,1993,3,5,0,0,0,2,draw,draw,729,5,1,0,0.28837373,0.337729817
26/05/1993,26,Yemen,Yemen,Iraq,Iraq,1,6,FIFA World Cup qualification,Irbid,Jordan,1993,3,5,-5,5,5,7,loser,winner,730,5,1,0,0.96989736,0.013184208
05/06/1993,5,Bahrain,Bahrain,Lebanon,Lebanon,0,0,FIFA World Cup qualification,Seoul,South Korea,1993,3,6,0,0,0,0,draw,draw,731,5,0,1,0.18630017,0.392456792
12/06/1993,12,Yemen,Yemen,Jordan,Jordan,1,1,FIFA World Cup qualification,Chengdu,China PR,1993,3,6,0,0,0,2,draw,draw,732,5,1,1,0.99008059,0.608862067
14/06/1993,14,Iraq,Iraq,Jordan,Jordan,4,0,FIFA World Cup qualification,Chengdu,China PR,1993,3,6,4,-4,4,4,winner,loser,733,5,0,1,0.47031711,0.449350358
16/06/1993,16,Iraq,Iraq,Yemen,Yemen,3,0,FIFA World Cup qualification,Chengdu,China PR,1993,3,6,3,-3,3,3,winner,loser,734,5,0,1,0.20277534,0.076854635
25/06/1993,25,Oman,Oman,Syria,Syria,0,0,FIFA World Cup qualification,Teheran,Iran,1993,3,6,0,0,0,0,draw,draw,735,5,1,0,0.58218391,0.605922783
04/07/1993,4,Syria,Syria,Oman,Oman,2,1,FIFA World Cup qualification,Damascus,Syria,1993,3,7,1,-1,1,3,winner,loser,736,5,0,1,0.99468762,0.753296203
11/07/1993,11,Egypt,Egypt,Morocco,Morocco,1,1,African Cup of Nations qualification,Alexandria,Egypt,1993,3,7,0,0,0,2,draw,draw,737,5,1,0,0.55896152,0.878567638
30/12/2014,30,Bahrain,Bahrain,Saudi Arabia,Saudi_Arabia,4,1,Friendly,South Geelong,Australia,2014,4,12,3,-3,3,5,winner,loser,1743,7,0,0,0.25664555,0.065964646
19/12/2002,19,Saudi Arabia,Saudi_Arabia,Lebanon,Lebanon,1,0,UAFA Cup,Kuwait City,Kuwait,2002,2,12,1,-1,1,1,winner,loser,1086,6,0,1,0.18987916,0.443338156
30/12/2002,30,Saudi Arabia,Saudi_Arabia,Bahrain,Bahrain,1,0,UAFA Cup,Kuwait City,Kuwait,2002,2,12,1,-1,1,1,winner,loser,1098,6,0,0,0.63582845,0.473085163
07/11/1993,7,Tunisia,Tunisia,Egypt,Egypt,2,1,Friendly,Tunis,Tunisia,1993,3,11,1,-1,1,3,winner,loser,741,5,1,1,0.65338538,0.214295158
02/02/1994,2,Egypt,Egypt,Morocco,Morocco,1,1,United Arab Emirates Friendship Tournament,Sharjah,United Arab Emirates,1994,4,2,0,0,0,2,draw,draw,742,5,1,0,0.18188367,0.444369403
30/09/2003,30,Saudi Arabia,Saudi_Arabia,Syria,Syria,1,1,Friendly,Riyadh,Saudi Arabia,2003,3,9,0,0,0,2,draw,draw,1113,6,0,0,0.16935744,0.30189995
06/10/2003,6,Saudi Arabia,Saudi_Arabia,Yemen,Yemen,7,0,AFC Asian Cup qualification,Jeddah,Saudi Arabia,2003,3,10,7,-7,7,7,winner,loser,1115,6,0,1,0.74309457,0.449419275
02/12/2010,2,UAE,UAE,Saudi Arabia,Saudi_Arabia,0,1,Gulf Cup,Aden,Yemen,2010,0,12,-1,1,1,1,loser,winner,1513,7,0,0,0.57880733,0.993870452
13/10/2003,13,Saudi Arabia,Saudi_Arabia,Yemen,Yemen,3,1,AFC Asian Cup qualification,Jeddah,Saudi Arabia,2003,3,10,2,-2,2,4,winner,loser,1120,6,0,1,0.79045657,0.436797986
04/09/1994,4,Sudan,Sudan,Egypt,Egypt,0,0,African Cup of Nations qualification,Khartoum,Sudan,1994,4,9,0,0,0,0,draw,draw,747,5,1,1,0.3491571,0.547777746
10/09/1994,10,Qatar,Qatar,Oman,Oman,0,2,Friendly,Doha,Qatar,1994,4,9,-2,2,2,2,loser,winner,748,5,1,1,0.36448202,0.324522385
14/09/1994,14,Oman,Oman,Sudan,Sudan,1,1,Friendly,Doha,Qatar,1994,4,9,0,0,0,2,draw,draw,749,5,1,1,0.88567229,0.681281634
16/09/1994,16,Qatar,Qatar,Yemen,Yemen,2,0,Friendly,Doha,Qatar,1994,4,9,2,-2,2,2,winner,loser,750,5,1,1,0.12322731,0.024510519
14/10/1994,14,Algeria,Algeria,Sudan,Sudan,1,1,African Cup of Nations qualification,Algiers,Algeria,1994,4,10,0,0,0,2,draw,draw,751,5,1,1,0.25530717,0.558114712
29/12/2003,29,Saudi Arabia,Saudi_Arabia,Qatar,Qatar,0,0,Gulf Cup,Kuwait City,Kuwait,2003,3,12,0,0,0,0,draw,draw,1137,6,0,1,0.01115212,0.587499418
04/11/1994,4,Bahrain,Bahrain,Kuwait,Kuwait,2,1,Gulf Cup,Abu Dhabi,United Arab Emirates,1994,4,11,1,-1,1,3,winner,loser,753,5,0,0,0.34201531,0.210282249
09/11/2015,9,Palestine,Palestine,Saudi Arabia,Saudi_Arabia,0,0,FIFA World Cup qualification,Amman,Jordan,2015,5,11,0,0,0,0,draw,draw,1785,7,0,0,0.64807694,0.980842108
26/07/2004,26,Saudi Arabia,Saudi_Arabia,Iraq,Iraq,1,2,AFC Asian Cup,Chengdu,China PR,2004,4,7,-1,1,1,3,loser,winner,1186,6,0,0,0.69456018,0.62396254
06/11/1994,6,Oman,Oman,Bahrain,Bahrain,1,1,Gulf Cup,Abu Dhabi,United Arab Emirates,1994,4,11,0,0,0,2,draw,draw,756,5,1,0,0.55596772,0.661256904
07/11/1994,7,Kuwait,Kuwait,Qatar,Qatar,1,0,Gulf Cup,Abu Dhabi,United Arab Emirates,1994,4,11,1,-1,1,1,winner,loser,757,5,0,1,0.0825279,0.034542073
09/11/1994,9,Qatar,Qatar,Oman,Oman,4,2,Gulf Cup,Abu Dhabi,United Arab Emirates,1994,4,11,2,-2,2,6,winner,loser,758,5,1,1,0.86494953,0.580574111
01/09/2004,1,Saudi Arabia,Saudi_Arabia,Kuwait,Kuwait,1,1,Friendly,Riyadh,Saudi Arabia,2004,4,9,0,0,0,2,draw,draw,1192,6,0,0,0.80263475,0.489902765
06/10/2004,6,Saudi Arabia,Saudi_Arabia,Syria,Syria,2,2,Friendly,Riyadh,Saudi Arabia,2004,4,10,0,0,0,4,draw,draw,1199,6,0,0,0.76379227,0.881499167
06/09/2016,6,Iraq,Iraq,Saudi Arabia,Saudi_Arabia,1,2,FIFA World Cup qualification,Shah Alam,Malaysia,2016,6,9,-1,1,1,3,loser,winner,1807,7,0,0,0.76454914,0.687754018
11/12/2004,11,Saudi Arabia,Saudi_Arabia,Kuwait,Kuwait,1,2,Gulf Cup,Rayyan,Qatar,2004,4,12,-1,1,1,3,loser,winner,1216,6,0,0,0.86091625,0.145303678
13/11/1994,13,Oman,Oman,Kuwait,Kuwait,0,0,Gulf Cup,Abu Dhabi,United Arab Emirates,1994,4,11,0,0,0,0,draw,draw,763,5,1,0,0.65183222,0.569258306
15/11/1994,15,Bahrain,Bahrain,Qatar,Qatar,1,1,Gulf Cup,Abu Dhabi,United Arab Emirates,1994,4,11,0,0,0,2,draw,draw,764,5,0,1,0.46977769,0.091511454
22/12/2017,22,Kuwait,Kuwait,Saudi Arabia,Saudi_Arabia,1,2,Gulf Cup,Kuwait City,Kuwait,2017,7,12,-1,1,1,3,loser,winner,1850,7,0,0,0.15310221,0.449671095
14/12/2004,14,Saudi Arabia,Saudi_Arabia,Yemen,Yemen,2,0,Gulf Cup,Rayyan,Qatar,2004,4,12,2,-2,2,2,winner,loser,1220,6,0,1,0.81681909,0.787391549
01/12/1994,1,Somalia,Somalia,Djibouti,Djibouti,2,1,CECAFA Cup,Nairobi,Kenya,1994,4,12,1,-1,1,3,winner,loser,767,5,1,0,0.36425743,0.323757072
16/12/1994,16,Tunisia,Tunisia,Algeria,Algeria,1,0,Friendly,Sfax,Tunisia,1994,4,12,1,-1,1,1,winner,loser,768,5,1,1,0.17192425,0.86760349
02/01/1995,2,Tunisia,Tunisia,Egypt,Egypt,2,0,Friendly,Sousse,Tunisia,1995,5,1,2,-2,2,2,winner,loser,769,5,1,1,0.27582521,0.623331177
29/01/1995,29,Tunisia,Tunisia,Mauritania,Mauritania,1,0,African Cup of Nations qualification,Tunis,Tunisia,1995,5,1,1,-1,1,1,winner,loser,770,5,1,1,0.42221096,0.88087129
26/03/1995,26,Lebanon,Lebanon,Egypt,Egypt,1,1,Friendly,Beirut,Lebanon,1995,5,3,0,0,0,2,draw,draw,771,5,1,1,0.99375049,0.110022963
31/03/1995,31,Syria,Syria,Egypt,Egypt,1,2,Friendly,Damascus,Syria,1995,5,3,-1,1,1,3,loser,winner,772,5,0,1,0.91318964,0.923027517
14/04/1995,14,Egypt,Egypt,Tunisia,Tunisia,1,0,Friendly,Port Said,Egypt,1995,5,4,1,-1,1,1,winner,loser,773,5,1,1,0.10811235,0.735867065
24/04/1995,24,Sudan,Sudan,Algeria,Algeria,2,0,African Cup of Nations qualification,Khartoum,Sudan,1995,5,4,2,-2,2,2,winner,loser,774,5,1,1,0.92028192,0.622540948
18/05/1995,18,Morocco,Morocco,Egypt,Egypt,0,0,Friendly,Marrakech,Morocco,1995,5,5,0,0,0,0,draw,draw,775,5,0,1,0.41818773,0.559744019
09/07/1995,9,Syria,Syria,Egypt,Egypt,0,0,Friendly,Damascus,Syria,1995,5,7,0,0,0,0,draw,draw,776,5,0,1,0.40084514,0.650615456
14/07/1995,14,Egypt,Egypt,Algeria,Algeria,1,1,African Cup of Nations qualification,Cairo,Egypt,1995,5,7,0,0,0,2,draw,draw,777,5,1,1,0.20021737,0.952126488
22/07/1995,22,Algeria,Algeria,Tunisia,Tunisia,2,1,Friendly,Algiers,Algeria,1995,5,7,1,-1,1,3,winner,loser,778,5,1,1,0.80200263,0.271096268
30/07/1995,30,Mauritania,Mauritania,Tunisia,Tunisia,0,0,African Cup of Nations qualification,Nouakchott,Mauritania,1995,5,7,0,0,0,0,draw,draw,779,5,1,1,0.51190221,0.241594006
03/11/1995,3,Algeria,Algeria,Mauritania,Mauritania,4,0,Friendly,Tunis,Tunisia,1995,5,11,4,-4,4,4,winner,loser,780,5,1,1,0.74022145,0.512103494
05/11/1995,5,Tunisia,Tunisia,Algeria,Algeria,2,0,Friendly,Tunis,Tunisia,1995,5,11,2,-2,2,2,winner,loser,781,5,1,1,0.89343062,0.478038584
07/11/1995,7,Tunisia,Tunisia,Mauritania,Mauritania,2,1,Friendly,Tunis,Tunisia,1995,5,11,1,-1,1,3,winner,loser,782,5,1,1,0.0257311,0.536761831
03/01/1996,3,Morocco,Morocco,Tunisia,Tunisia,3,1,Friendly,Rabat,Morocco,1996,6,1,2,-2,2,4,winner,loser,783,5,0,1,0.10801493,0.807141832
08/01/1996,8,Egypt,Egypt,Tunisia,Tunisia,2,1,Friendly,Ismailia,Egypt,1996,6,1,1,-1,1,3,winner,loser,784,5,1,1,0.05873871,0.432667868
14/03/2005,14,Saudi Arabia,Saudi_Arabia,Egypt,Egypt,0,1,Friendly,Dammam,Saudi Arabia,2005,5,3,-1,1,1,1,loser,winner,1232,6,0,1,0.40288146,0.588753558
27/05/2005,27,Saudi Arabia,Saudi_Arabia,Bahrain,Bahrain,1,1,Friendly,Riyadh,Saudi Arabia,2005,5,5,0,0,0,2,draw,draw,1236,6,0,0,0.17594071,0.748567932
24/02/1996,24,Kuwait,Kuwait,Oman,Oman,1,0,Friendly,Kuwait City,Kuwait,1996,6,2,1,-1,1,1,winner,loser,787,5,0,1,0.7879657,0.308314944
02/03/1996,2,Oman,Oman,Kuwait,Kuwait,0,3,Friendly,Muscat,Oman,1996,6,3,-3,3,3,3,loser,winner,788,5,1,0,0.97759365,0.493319558
05/03/1996,5,Syria,Syria,Kuwait,Kuwait,0,2,Friendly,Damascus,Syria,1996,6,3,-2,2,2,2,loser,winner,789,5,0,0,0.24352841,0.000872445
20/03/1996,20,Egypt,Egypt,Morocco,Morocco,0,2,United Arab Emirates Friendship Tournament,Dubai,United Arab Emirates,1996,6,3,-2,2,2,2,loser,winner,790,5,1,0,0.89314324,0.430244694
03/06/2005,3,Saudi Arabia,Saudi_Arabia,Kuwait,Kuwait,3,0,FIFA World Cup qualification,Riyadh,Saudi Arabia,2005,5,6,3,-3,3,3,winner,loser,1237,6,0,0,0.11341905,0.961017616
03/12/2005,3,Saudi Arabia,Saudi_Arabia,Palestine,Palestine,2,0,Friendly,Rayyan,Qatar,2005,5,12,2,-2,2,2,winner,loser,1256,6,0,0,0.26274334,0.37953444
21/04/1996,21,Qatar,Qatar,Kuwait,Kuwait,3,1,Friendly,Doha,Qatar,1996,6,4,2,-2,2,4,winner,loser,793,5,1,0,0.19768372,0.262219648
23/05/1996,23,Kuwait,Kuwait,Syria,Syria,3,1,Friendly,Kuwait City,Kuwait,1996,6,5,2,-2,2,4,winner,loser,794,5,0,0,0.95817919,0.289481857
03/06/1996,3,Oman,Oman,Bahrain,Bahrain,3,0,Friendly,Muscat,Oman,1996,6,6,3,-3,3,3,winner,loser,795,5,1,0,0.04706561,0.933549585
09/06/1996,9,Lebanon,Lebanon,Kuwait,Kuwait,3,5,AFC Asian Cup qualification,Beirut,Lebanon,1996,6,6,-2,2,2,8,loser,winner,796,5,1,0,0.33322709,0.371563263
20/06/1996,20,Kuwait,Kuwait,Lebanon,Lebanon,0,0,AFC Asian Cup qualification,Kuwait City,Kuwait,1996,6,6,0,0,0,0,draw,draw,797,5,0,1,0.19061083,0.438900473
28/06/1996,28,Qatar,Qatar,Syria,Syria,1,0,AFC Asian Cup qualification,Doha,Qatar,1996,6,6,1,-1,1,1,winner,loser,798,5,1,0,0.18962144,0.341597756
19/07/1996,19,Syria,Syria,Qatar,Qatar,3,1,AFC Asian Cup qualification,Damascus,Syria,1996,6,7,2,-2,2,4,winner,loser,799,5,0,1,0.07994698,0.770797188
13/08/1996,13,Jordan,Jordan,Iraq,Iraq,0,1,AFC Asian Cup qualification,Amman,Jordan,1996,6,8,-1,1,1,1,loser,winner,800,5,1,0,0.61616789,0.799380924
28/08/1996,28,Oman,Oman,Sudan,Sudan,0,0,Friendly,Muscat,Oman,1996,6,8,0,0,0,0,draw,draw,801,5,1,1,0.73982689,0.136352092
31/08/1996,31,Oman,Oman,Sudan,Sudan,0,1,Friendly,Muscat,Oman,1996,6,8,-1,1,1,1,loser,winner,802,5,1,1,0.6806931,0.778108481
05/09/1996,5,Lebanon,Lebanon,Oman,Oman,1,2,Friendly,Beirut,Lebanon,1996,6,9,-1,1,1,3,loser,winner,803,5,1,1,0.39607022,0.392344866
25/09/1996,25,Syria,Syria,Sudan,Sudan,1,2,Friendly,Damascus,Syria,1996,6,9,-1,1,1,3,loser,winner,804,5,0,1,0.43147335,0.752865629
29/09/1996,29,Syria,Syria,Sudan,Sudan,1,0,Friendly,Damascus,Syria,1996,6,9,1,-1,1,1,winner,loser,805,5,0,1,0.80507782,0.450857587
03/10/1996,3,Lebanon,Lebanon,Bahrain,Bahrain,2,3,Friendly,Tripoli,Lebanon,1996,6,10,-1,1,1,5,loser,winner,806,5,1,0,0.42869719,0.175197887
28/02/2018,28,Iraq,Iraq,Saudi Arabia,Saudi_Arabia,4,1,Friendly,Basra,Iraq,2018,8,2,3,-3,3,5,winner,loser,1871,7,0,0,0.2767414,0.864694685
16/10/1996,16,Kuwait,Kuwait,Bahrain,Bahrain,1,0,Gulf Cup,Muscat,Oman,1996,6,10,1,-1,1,1,winner,loser,808,5,0,0,0.87039529,0.065621774
27/01/2006,27,Saudi Arabia,Saudi_Arabia,Lebanon,Lebanon,1,2,Friendly,Riyadh,Saudi Arabia,2006,6,1,-1,1,1,3,loser,winner,1267,6,0,1,0.41566429,0.42451443
18/10/1996,18,Oman,Oman,Kuwait,Kuwait,1,2,Gulf Cup,Muscat,Oman,1996,6,10,-1,1,1,3,loser,winner,810,5,1,0,0.10214441,0.021066301
14/02/2006,14,Saudi Arabia,Saudi_Arabia,Syria,Syria,1,1,Friendly,Jeddah,Saudi Arabia,2006,6,2,0,0,0,2,draw,draw,1273,6,0,0,0.64656943,0.078147607
09/05/2018,9,Algeria,Algeria,Saudi Arabia,Saudi_Arabia,0,2,Friendly,Cádiz,Spain,2018,8,5,-2,2,2,2,loser,winner,1879,7,1,0,0.17736205,0.713969683
21/10/1996,21,Oman,Oman,Qatar,Qatar,0,3,Gulf Cup,Muscat,Oman,1996,6,10,-3,3,3,3,loser,winner,813,5,1,1,0.3085409,0.293966928
15/03/2006,15,Saudi Arabia,Saudi_Arabia,Iraq,Iraq,2,2,Friendly,Jeddah,Saudi Arabia,2006,6,3,0,0,0,4,draw,draw,1280,6,0,0,0.34911086,0.933408848
29/03/2016,29,UAE,UAE,Saudi Arabia,Saudi_Arabia,1,1,FIFA World Cup qualification,Abu Dhabi,United Arab Emirates,2016,6,3,0,0,0,2,draw,draw,1798,7,0,0,0.82899467,0.777628493
20/11/2018,20,Jordan,Jordan,Saudi Arabia,Saudi_Arabia,1,1,Friendly,Amman,Jordan,2018,8,11,0,0,0,2,draw,draw,1896,7,1,0,0.36287066,0.881627587
12/01/2019,12,Lebanon,Lebanon,Saudi Arabia,Saudi_Arabia,0,2,AFC Asian Cup,Dubai,United Arab Emirates,2019,9,1,-2,2,2,2,loser,winner,1911,7,1,0,0.05283203,0.700857651
25/10/1996,25,Bahrain,Bahrain,Qatar,Qatar,1,2,Gulf Cup,Muscat,Oman,1996,6,10,-1,1,1,3,loser,winner,818,5,0,1,0.73458391,0.339687368
09/08/2006,9,Saudi Arabia,Saudi_Arabia,Bahrain,Bahrain,1,0,Friendly,Riyadh,Saudi Arabia,2006,6,8,1,-1,1,1,winner,loser,1290,6,0,0,0.37798142,0.241111074
28/10/1996,28,Oman,Oman,Bahrain,Bahrain,1,1,Gulf Cup,Muscat,Oman,1996,6,10,0,0,0,2,draw,draw,820,5,1,0,0.86930687,0.712753757
28/10/1996,28,Qatar,Qatar,Kuwait,Kuwait,1,2,Gulf Cup,Muscat,Oman,1996,6,10,-1,1,1,3,loser,winner,821,5,1,0,0.27903751,0.106622766
29/08/2017,29,UAE,UAE,Saudi Arabia,Saudi_Arabia,2,1,FIFA World Cup qualification,al-Ain,United Arab Emirates,2017,7,8,1,-1,1,3,winner,loser,1843,7,0,0,0.03851989,0.218938283
19/11/1996,19,Kuwait,Kuwait,Syria,Syria,2,2,Friendly,Kuwait City,Kuwait,1996,6,11,0,0,0,4,draw,draw,823,5,0,0,0.71905465,0.462499222
11/10/2006,11,Saudi Arabia,Saudi_Arabia,Yemen,Yemen,5,0,AFC Asian Cup qualification,Jeddah,Saudi Arabia,2006,6,10,5,-5,5,5,winner,loser,1303,6,0,1,0.47100955,0.787397916
08/11/2006,8,Saudi Arabia,Saudi_Arabia,Jordan,Jordan,2,1,Friendly,Riyadh,Saudi Arabia,2006,6,11,1,-1,1,3,winner,loser,1305,6,0,1,0.60507115,0.634858758
11/01/2007,11,Saudi Arabia,Saudi_Arabia,Syria,Syria,2,1,Friendly,Dammam,Saudi Arabia,2007,7,1,1,-1,1,3,winner,loser,1319,6,0,0,0.99214197,0.491630584
18/01/2007,18,Saudi Arabia,Saudi_Arabia,Bahrain,Bahrain,2,1,Gulf Cup,Abu Dhabi,United Arab Emirates,2007,7,1,1,-1,1,3,winner,loser,1324,6,0,0,0.73773203,0.100716653
21/01/2007,21,Saudi Arabia,Saudi_Arabia,Qatar,Qatar,1,1,Gulf Cup,Abu Dhabi,United Arab Emirates,2007,7,1,0,0,0,2,draw,draw,1328,6,0,1,0.13281342,0.092847218
24/01/2007,24,Saudi Arabia,Saudi_Arabia,Iraq,Iraq,1,0,Gulf Cup,Abu Dhabi,United Arab Emirates,2007,7,1,1,-1,1,1,winner,loser,1332,6,0,0,0.91556464,0.321333253
18/07/2007,18,Saudi Arabia,Saudi_Arabia,Bahrain,Bahrain,4,0,AFC Asian Cup,Palembang,Indonesia,2007,7,7,4,-4,4,4,winner,loser,1354,6,0,0,0.14153069,0.430021203
04/01/1997,4,Tunisia,Tunisia,Algeria,Algeria,0,0,Friendly,Sfax,Tunisia,1997,7,1,0,0,0,0,draw,draw,831,5,1,1,0.33102135,0.659633127
12/01/1997,12,Lebanon,Lebanon,Algeria,Algeria,2,2,Friendly,Beirut,Lebanon,1997,7,1,0,0,0,4,draw,draw,832,5,1,1,0.00536343,0.017836946
12/01/1997,12,Tunisia,Tunisia,Egypt,Egypt,1,0,FIFA World Cup qualification,Tunis,Tunisia,1997,7,1,1,-1,1,1,winner,loser,833,5,1,1,0.84006264,0.853802427
02/02/1997,2,Lebanon,Lebanon,Jordan,Jordan,1,0,Friendly,Beirut,Lebanon,1997,7,2,1,-1,1,1,winner,loser,834,5,1,1,0.41604018,0.395316465
07/02/1997,7,Jordan,Jordan,Lebanon,Lebanon,0,0,Friendly,Amman,Jordan,1997,7,2,0,0,0,0,draw,draw,835,5,1,1,0.57996641,0.272966813
09/02/1997,9,Lebanon,Lebanon,Jordan,Jordan,0,0,Friendly,Beirut,Lebanon,1997,7,2,0,0,0,0,draw,draw,836,5,1,1,0.30355207,0.020367286
16/02/1997,16,Iraq,Iraq,Jordan,Jordan,1,0,Friendly,Baghdad,Iraq,1997,7,2,1,-1,1,1,winner,loser,837,5,0,1,0.06277217,0.494278397
18/02/1997,18,Kuwait,Kuwait,Egypt,Egypt,2,0,Friendly,Kuwait City,Kuwait,1997,7,2,2,-2,2,2,winner,loser,838,5,0,1,0.63121857,0.031991265
24/05/2008,24,Saudi Arabia,Saudi_Arabia,Syria,Syria,1,0,Friendly,Riyadh,Saudi Arabia,2008,8,5,1,-1,1,1,winner,loser,1389,6,0,0,0.71088995,0.573517237
06/03/1997,6,Bahrain,Bahrain,Oman,Oman,1,0,Friendly,Muharraq,Bahrain,1997,7,3,1,-1,1,1,winner,loser,840,5,0,1,0.69928746,0.108502235
18/03/1997,18,Kuwait,Kuwait,Bahrain,Bahrain,3,1,Friendly,Kuwait City,Kuwait,1997,7,3,2,-2,2,4,winner,loser,841,5,0,0,0.70810655,0.58461412
27/05/2008,27,Saudi Arabia,Saudi_Arabia,Kuwait,Kuwait,2,1,Friendly,Dammam,Saudi Arabia,2008,8,5,1,-1,1,3,winner,loser,1391,6,0,0,0.20622164,0.043828583
25/12/2017,25,UAE,UAE,Saudi Arabia,Saudi_Arabia,0,0,Gulf Cup,Kuwait City,Kuwait,2017,7,12,0,0,0,0,draw,draw,1856,7,0,0,0.2246779,0.288742613
10/09/2019,10,Yemen,Yemen,Saudi Arabia,Saudi_Arabia,2,2,FIFA World Cup qualification,Riffa,Bahrain,2019,9,9,0,0,0,4,draw,draw,1924,7,1,0,0.42863982,0.92475566
14/04/1997,14,Bahrain,Bahrain,Jordan,Jordan,1,0,FIFA World Cup qualification,Manama,Bahrain,1997,7,4,1,-1,1,1,winner,loser,845,5,0,1,0.04807138,0.410691475
19/04/1997,19,Jordan,Jordan,Bahrain,Bahrain,4,1,FIFA World Cup qualification,Sharjah,United Arab Emirates,1997,7,4,3,-3,3,5,winner,loser,846,5,1,0,0.74449027,0.032753848
02/06/2008,2,Saudi Arabia,Saudi_Arabia,Lebanon,Lebanon,4,1,FIFA World Cup qualification,Riyadh,Saudi Arabia,2008,8,6,3,-3,3,5,winner,loser,1392,6,0,1,0.57189415,0.076209031
07/06/2008,7,Saudi Arabia,Saudi_Arabia,Lebanon,Lebanon,2,1,FIFA World Cup qualification,Riyadh,Saudi Arabia,2008,8,6,1,-1,1,3,winner,loser,1395,6,0,1,0.35094961,0.963498061
27/04/1997,27,Lebanon,Lebanon,Libya,Libya,2,0,Friendly,Beirut,Lebanon,1997,7,4,2,-2,2,2,winner,loser,849,5,1,0,0.00331112,0.940133577
30/04/1997,30,Syria,Syria,Libya,Libya,1,1,Friendly,Damascus,Syria,1997,7,4,0,0,0,2,draw,draw,850,5,0,0,0.80620957,0.445978993
08/05/1997,8,Kuwait,Kuwait,Lebanon,Lebanon,2,0,FIFA World Cup qualification,Kuwait City,Kuwait,1997,7,5,2,-2,2,2,winner,loser,851,5,0,1,0.62871361,0.542552138
31/05/1997,31,Tunisia,Tunisia,Algeria,Algeria,0,1,Friendly,Tunis,Tunisia,1997,7,5,-1,1,1,1,loser,winner,852,5,1,1,0.21957733,0.433843881
06/06/1997,6,Palestine,Palestine,Jordan,Jordan,0,0,Friendly,Jericho,Palestine,1997,7,6,0,0,0,0,draw,draw,853,5,0,1,0.56633429,0.81793297
08/06/1997,8,Egypt,Egypt,Tunisia,Tunisia,0,0,FIFA World Cup qualification,Cairo,Egypt,1997,7,6,0,0,0,0,draw,draw,854,5,1,1,0.51520004,0.547002127
21/06/1997,21,Morocco,Morocco,Egypt,Egypt,1,0,African Cup of Nations qualification,Rabat,Morocco,1997,7,6,1,-1,1,1,winner,loser,855,5,0,1,0.33984511,0.847199419
22/06/1997,22,Lebanon,Lebanon,Kuwait,Kuwait,1,3,FIFA World Cup qualification,Beirut,Lebanon,1997,7,6,-2,2,2,4,loser,winner,856,5,1,0,0.37546296,0.388485129
21/08/1997,21,Lebanon,Lebanon,Iraq,Iraq,0,2,Friendly,Beirut,Lebanon,1997,7,8,-2,2,2,2,loser,winner,857,5,1,0,0.24435229,0.497916862
30/08/2008,30,Saudi Arabia,Saudi_Arabia,Qatar,Qatar,2,1,Friendly,Dammam,Saudi Arabia,2008,8,8,1,-1,1,3,winner,loser,1408,6,0,1,0.86375972,0.173223116
19/09/1997,19,Qatar,Qatar,Kuwait,Kuwait,0,2,FIFA World Cup qualification,Doha,Qatar,1997,7,9,-2,2,2,2,loser,winner,859,5,1,0,0.42055577,0.728503924
20/09/1997,20,Libya,Libya,Bahrain,Bahrain,2,1,Friendly,Tripoli,Libya,1997,7,9,1,-1,1,3,winner,loser,860,5,0,0,0.0699879,0.635549497
25/09/1997,25,Libya,Libya,Jordan,Jordan,1,1,Friendly,Tripoli,Libya,1997,7,9,0,0,0,2,draw,draw,861,5,0,1,0.43476859,0.54535107
12/11/2008,12,Saudi Arabia,Saudi_Arabia,Bahrain,Bahrain,4,0,Friendly,Riyadh,Saudi Arabia,2008,8,11,4,-4,4,4,winner,loser,1415,6,0,0,0.44092069,0.565035149
15/10/2019,15,Palestine,Palestine,Saudi Arabia,Saudi_Arabia,0,0,FIFA World Cup qualification,Al Ram,Palestine,2019,9,10,0,0,0,0,draw,draw,1930,7,0,0,0.6864745,0.198134896
24/10/1997,24,Kuwait,Kuwait,Qatar,Qatar,0,1,FIFA World Cup qualification,Kuwait City,Kuwait,1997,7,10,-1,1,1,1,loser,winner,864,5,0,1,0.91105838,0.293378852
21/03/2019,21,UAE,UAE,Saudi Arabia,Saudi_Arabia,2,1,Friendly,Abu Dhabi,United Arab Emirates,2019,9,3,1,-1,1,3,winner,loser,1916,7,0,0,0.795933,0.21600386
20/12/1997,20,Egypt,Egypt,Algeria,Algeria,1,2,Friendly,Aswan,Egypt,1997,7,12,-1,1,1,3,loser,winner,866,5,1,1,0.19321165,0.409465665
24/12/1997,24,Egypt,Egypt,Algeria,Algeria,1,2,Friendly,Cairo,Egypt,1997,7,12,-1,1,1,3,loser,winner,867,5,1,1,0.4301571,0.193228169
17/02/1998,17,Egypt,Egypt,Morocco,Morocco,0,1,African Cup of Nations,Ouagadougou,Burkina Faso,1998,8,2,-1,1,1,1,loser,winner,868,5,1,0,0.92321071,0.943866728
02/07/1998,2,Oman,Oman,Syria,Syria,1,2,Friendly,Muscat,Oman,1998,8,7,-1,1,1,3,loser,winner,869,5,1,0,0.45099112,0.862969925
20/07/1998,20,Lebanon,Lebanon,Palestine,Palestine,3,1,UAFA Cup,Beirut,Lebanon,1998,8,7,2,-2,2,4,winner,loser,870,5,1,0,0.18542614,0.64126714
20/07/1998,20,Syria,Syria,Jordan,Jordan,3,0,UAFA Cup,Beirut,Lebanon,1998,8,7,3,-3,3,3,winner,loser,871,5,0,1,0.06865804,0.704681517
23/07/1998,23,Lebanon,Lebanon,Jordan,Jordan,0,2,UAFA Cup,Beirut,Lebanon,1998,8,7,-2,2,2,2,loser,winner,872,5,1,1,0.74412332,0.841796633
23/07/1998,23,Palestine,Palestine,Syria,Syria,1,2,UAFA Cup,Beirut,Lebanon,1998,8,7,-1,1,1,3,loser,winner,873,5,0,0,0.28329337,0.006993594
26/07/1998,26,Jordan,Jordan,Palestine,Palestine,1,1,UAFA Cup,Beirut,Lebanon,1998,8,7,0,0,0,2,draw,draw,874,5,1,0,0.37966934,0.773740581
26/07/1998,26,Lebanon,Lebanon,Syria,Syria,0,1,UAFA Cup,Beirut,Lebanon,1998,8,7,-1,1,1,1,loser,winner,875,5,1,0,0.71422051,0.216762143
31/07/1998,31,Libya,Libya,Algeria,Algeria,0,2,African Cup of Nations qualification,Tripoli,Libya,1998,8,7,-2,2,2,2,loser,winner,876,5,0,1,0.00043917,0.213940424
14/08/1998,14,Algeria,Algeria,Libya,Libya,3,0,African Cup of Nations qualification,Algiers,Algeria,1998,8,8,3,-3,3,3,winner,loser,877,5,1,0,0.77917301,0.564725551
09/09/1998,9,Kuwait,Kuwait,Lebanon,Lebanon,0,0,Friendly,Kuwait City,Kuwait,1998,8,9,0,0,0,0,draw,draw,878,5,0,1,0.98084391,0.60042087
12/09/1998,12,Syria,Syria,Oman,Oman,3,0,Friendly,Damascus,Syria,1998,8,9,3,-3,3,3,winner,loser,879,5,0,1,0.90838732,0.40730812
13/09/1998,13,Bahrain,Bahrain,Libya,Libya,2,2,Friendly,Doha,Qatar,1998,8,9,0,0,0,4,draw,draw,880,5,0,0,0.25957781,0.617518557
27/12/2008,27,Saudi Arabia,Saudi_Arabia,Syria,Syria,1,1,Friendly,Dammam,Saudi Arabia,2008,8,12,0,0,0,2,draw,draw,1418,6,0,0,0.25555968,0.386472855
15/09/1998,15,Syria,Syria,Oman,Oman,0,0,Friendly,Damascus,Syria,1998,8,9,0,0,0,0,draw,draw,882,5,0,1,0.56761364,0.232755981
16/09/1998,16,Qatar,Qatar,Sudan,Sudan,1,1,Friendly,Doha,Qatar,1998,8,9,0,0,0,2,draw,draw,883,5,1,1,0.35791476,0.3018143
05/01/2009,5,Saudi Arabia,Saudi_Arabia,Qatar,Qatar,0,0,Gulf Cup,Muscat,Oman,2009,9,1,0,0,0,0,draw,draw,1425,6,0,1,0.01564855,0.977967401
18/09/1998,18,Bahrain,Bahrain,Syria,Syria,2,0,Friendly,Manama,Bahrain,1998,8,9,2,-2,2,2,winner,loser,885,5,0,0,0.9029228,0.590584941
22/09/1998,22,Qatar,Qatar,Libya,Libya,2,1,UAFA Cup,Doha,Qatar,1998,8,9,1,-1,1,3,winner,loser,886,5,1,0,0.49966598,0.602884232
24/09/1998,24,Libya,Libya,Jordan,Jordan,1,2,UAFA Cup,Doha,Qatar,1998,8,9,-1,1,1,3,loser,winner,887,5,0,1,0.75176048,0.380453779
26/09/1998,26,Kuwait,Kuwait,Syria,Syria,4,0,UAFA Cup,Doha,Qatar,1998,8,9,4,-4,4,4,winner,loser,888,5,0,0,0.52062997,0.435166716
26/09/1998,26,Qatar,Qatar,Jordan,Jordan,2,0,UAFA Cup,Doha,Qatar,1998,8,9,2,-2,2,2,winner,loser,889,5,1,1,0.3266978,0.996846728
08/01/2009,8,Saudi Arabia,Saudi_Arabia,Yemen,Yemen,6,0,Gulf Cup,Muscat,Oman,2009,9,1,6,-6,6,6,winner,loser,1430,6,0,1,0.39563248,0.07045026
22/03/2009,22,Saudi Arabia,Saudi_Arabia,Iraq,Iraq,0,0,Friendly,Riyadh,Saudi Arabia,2009,9,3,0,0,0,0,draw,draw,1443,6,0,0,0.32869204,0.519708354
30/11/2019,30,Bahrain,Bahrain,Saudi Arabia,Saudi_Arabia,0,2,Gulf Cup,Doha,Qatar,2019,9,11,-2,2,2,2,loser,winner,1946,7,0,0,0.65716586,0.50555258
02/12/2019,2,Oman,Oman,Saudi Arabia,Saudi_Arabia,1,3,Gulf Cup,Doha,Qatar,2019,9,12,-2,2,2,4,loser,winner,1950,7,1,0,0.8262763,0.881960198
05/12/2019,5,Qatar,Qatar,Saudi Arabia,Saudi_Arabia,0,1,Gulf Cup,Al Wakrah,Qatar,2019,9,12,-1,1,1,1,loser,winner,1952,7,1,0,0.03856079,0.015616214
08/12/2019,8,Bahrain,Bahrain,Saudi Arabia,Saudi_Arabia,1,0,Gulf Cup,Doha,Qatar,2019,9,12,1,-1,1,1,winner,loser,1953,7,0,0,0.41470399,0.247691641
03/10/1998,3,Bahrain,Bahrain,Sudan,Sudan,2,3,Friendly,Manama,Bahrain,1998,8,10,-1,1,1,5,loser,winner,896,5,0,1,0.19570736,0.728551259
17/10/1998,17,Lebanon,Lebanon,Syria,Syria,3,3,United Arab Emirates Friendship Tournament,Abu Dhabi,United Arab Emirates,1998,8,10,0,0,0,6,draw,draw,897,5,1,0,0.80987177,0.46301401
09/09/2009,9,Saudi Arabia,Saudi_Arabia,Bahrain,Bahrain,2,2,FIFA World Cup qualification,Riyadh,Saudi Arabia,2009,9,9,0,0,0,4,draw,draw,1457,6,0,0,0.13847142,0.646263388
19/10/1998,19,Lebanon,Lebanon,Sudan,Sudan,1,1,United Arab Emirates Friendship Tournament,Abu Dhabi,United Arab Emirates,1998,8,10,0,0,0,2,draw,draw,899,5,1,1,0.4001585,0.05361537
25/11/2010,25,Saudi Arabia,Saudi_Arabia,Kuwait,Kuwait,0,0,Gulf Cup,Zinjibar,Yemen,2010,0,11,0,0,0,0,draw,draw,1504,7,0,0,0.73491281,0.525408376
21/10/1998,21,Sudan,Sudan,Syria,Syria,2,3,United Arab Emirates Friendship Tournament,Abu Dhabi,United Arab Emirates,1998,8,10,-1,1,1,5,loser,winner,901,5,1,0,0.61364993,0.207756917
28/12/2010,28,Saudi Arabia,Saudi_Arabia,Iraq,Iraq,0,1,Friendly,Dammam,Saudi Arabia,2010,0,12,-1,1,1,1,loser,winner,1519,7,0,0,0.98616794,0.793139408
07/09/2021,7,Oman,Oman,Saudi Arabia,Saudi_Arabia,0,1,FIFA World Cup qualification,Muscat,Oman,2021,1,9,-1,1,1,1,loser,winner,1992,8,1,0,0.73978803,0.160302715
18/11/1963,18,Egypt,Egypt,Saudi Arabia,Saudi_Arabia,7,0,Friendly,Jakarta,Indonesia,1963,3,11,7,-7,7,7,winner,loser,28,2,1,0,0.51864121,0.977026693
31/10/1998,31,Oman,Oman,Qatar,Qatar,2,1,Gulf Cup,Manama,Bahrain,1998,8,10,1,-1,1,3,winner,loser,905,5,1,1,0.03048853,0.592496004
13/10/2015,13,Mauritania,Mauritania,South Sudan,South_Sudan,4,0,FIFA World Cup qualification,Nouakchott,Mauritania,2015,5,10,4,-4,4,4,winner,loser,1781,7,1,0,0.41241491,0.486677928
02/11/1998,2,Kuwait,Kuwait,Qatar,Qatar,6,2,Gulf Cup,Manama,Bahrain,1998,8,11,4,-4,4,8,winner,loser,907,5,0,1,0.43004639,0.72038687
09/01/2011,9,Saudi Arabia,Saudi_Arabia,Syria,Syria,1,2,AFC Asian Cup,Rayyan,Qatar,2011,1,1,-1,1,1,3,loser,winner,1521,7,0,0,0.28083792,0.655254466
22/03/2017,22,Djibouti,Djibouti,South Sudan,South_Sudan,2,0,African Cup of Nations qualification,Djibouti,Djibouti,2017,7,3,2,-2,2,2,winner,loser,1824,7,0,0,0.08757316,0.00353763
22/04/2017,22,Somalia,Somalia,South Sudan,South_Sudan,1,2,African Nations Championship,Djibouti,Djibouti,2017,7,4,-1,1,1,3,loser,winner,1829,7,1,0,0.60916915,0.212115222
06/11/1998,6,Bahrain,Bahrain,Kuwait,Kuwait,0,2,Gulf Cup,Manama,Bahrain,1998,8,11,-2,2,2,2,loser,winner,911,5,0,0,0.94080693,0.337381323
08/11/1998,8,Bahrain,Bahrain,Qatar,Qatar,0,0,Gulf Cup,Manama,Bahrain,1998,8,11,0,0,0,0,draw,draw,912,5,0,1,0.85580061,0.097980358
15/11/2011,15,Saudi Arabia,Saudi_Arabia,Oman,Oman,0,0,FIFA World Cup qualification,Riyadh,Saudi Arabia,2011,1,11,0,0,0,0,draw,draw,1568,7,0,1,0.25674587,0.120560122
09/11/1998,9,Oman,Oman,Kuwait,Kuwait,0,5,Gulf Cup,Manama,Bahrain,1998,8,11,-5,5,5,5,loser,winner,914,5,1,0,0.96239228,0.438386039
21/06/2021,21,Jordan,Jordan,South Sudan,South_Sudan,3,0,FIFA Arab Cup qualification,Doha,Qatar,2021,1,6,3,-3,3,3,winner,loser,1982,8,1,0,0.39267131,0.364649812
12/11/1998,12,Bahrain,Bahrain,Oman,Oman,2,2,Gulf Cup,Manama,Bahrain,1998,8,11,0,0,0,4,draw,draw,916,5,0,1,0.83818732,0.850144517
18/06/2012,18,Saudi Arabia,Saudi_Arabia,Morocco,Morocco,4,0,Friendly,Ta’if,Saudi Arabia,2012,2,6,4,-4,4,4,winner,loser,1586,7,0,0,0.08525777,0.990322353
27/12/1998,27,Kuwait,Kuwait,Egypt,Egypt,1,1,Friendly,Kuwait City,Kuwait,1998,8,12,0,0,0,2,draw,draw,918,5,0,1,0.36873738,0.947913219
06/06/1999,6,Tunisia,Tunisia,Algeria,Algeria,2,0,African Cup of Nations qualification,Tunis,Tunisia,1999,9,6,2,-2,2,2,winner,loser,919,5,1,1,0.02546516,0.909864601
22/06/2012,22,Saudi Arabia,Saudi_Arabia,Kuwait,Kuwait,4,0,UAFA Cup,Ta’if,Saudi Arabia,2012,2,6,4,-4,4,4,winner,loser,1588,7,0,0,0.47688375,0.85954796
28/06/2012,28,Saudi Arabia,Saudi_Arabia,Palestine,Palestine,2,2,UAFA Cup,Ta’if,Saudi Arabia,2012,2,6,0,0,0,4,draw,draw,1596,7,0,0,0.59259156,0.626987501
28/06/1999,28,Jordan,Jordan,Iraq,Iraq,0,1,Friendly,Amman,Jordan,1999,9,6,-1,1,1,1,loser,winner,922,5,1,0,0.94208626,0.961951544
30/06/1999,30,Jordan,Jordan,Iraq,Iraq,1,1,Friendly,Amman,Jordan,1999,9,6,0,0,0,2,draw,draw,923,5,1,0,0.44450625,0.291318666
16/07/1999,16,Jordan,Jordan,Syria,Syria,1,0,Friendly,Amman,Jordan,1999,9,7,1,-1,1,1,winner,loser,924,5,1,0,0.26266373,0.217904543
18/07/1999,18,Jordan,Jordan,Syria,Syria,4,0,Friendly,Amman,Jordan,1999,9,7,4,-4,4,4,winner,loser,925,5,1,0,0.78378038,0.892272797
19/03/1972,19,Saudi Arabia,Saudi_Arabia,UAE,UAE,4,0,Gulf Cup,Riyadh,Saudi Arabia,1972,2,3,4,-4,4,4,winner,loser,153,3,0,0,0.32021967,0.47540518
05/08/1999,5,Iraq,Iraq,Oman,Oman,2,0,AFC Asian Cup qualification,Dushanbe,Tajikistan,1999,9,8,2,-2,2,2,winner,loser,927,5,0,1,0.88088253,0.278494651
17/03/1972,17,Qatar,Qatar,UAE,UAE,0,1,Gulf Cup,Riyadh,Saudi Arabia,1972,2,3,-1,1,1,1,loser,winner,151,3,1,0,0.73656849,0.13204524
03/07/2012,3,Saudi Arabia,Saudi_Arabia,Libya,Libya,0,2,UAFA Cup,Jeddah,Saudi Arabia,2012,2,7,-2,2,2,2,loser,winner,1601,7,0,0,0.10229895,0.041826472
29/01/2000,29,Tunisia,Tunisia,Morocco,Morocco,0,0,African Cup of Nations,Lagos,Nigeria,2000,0,1,0,0,0,0,draw,draw,930,6,1,0,0.43974032,0.278577214
31/01/2000,31,Kuwait,Kuwait,Syria,Syria,4,0,Friendly,Kuwait City,Kuwait,2000,0,1,4,-4,4,4,winner,loser,931,6,0,0,0.26375617,0.891393449
07/02/2000,7,Egypt,Egypt,Tunisia,Tunisia,0,1,African Cup of Nations,Kano,Nigeria,2000,0,2,-1,1,1,1,loser,winner,932,6,1,1,0.57819042,0.232600157
16/02/2000,16,Kuwait,Kuwait,Yemen,Yemen,2,0,AFC Asian Cup qualification,Kuwait City,Kuwait,2000,0,2,2,-2,2,2,winner,loser,933,6,0,1,0.99480974,0.252194533
22/03/1972,22,Kuwait,Kuwait,UAE,UAE,7,0,Gulf Cup,Riyadh,Saudi Arabia,1972,2,3,7,-7,7,7,winner,loser,155,3,0,0,0.01181848,0.899547642
23/02/2000,23,Lebanon,Lebanon,Jordan,Jordan,1,1,Friendly,Tripoli,Lebanon,2000,0,2,0,0,0,2,draw,draw,935,6,1,1,0.32851818,0.037669613
06/03/2000,6,Syria,Syria,Jordan,Jordan,0,0,Friendly,Damascus,Syria,2000,0,3,0,0,0,0,draw,draw,936,6,0,1,0.77418925,0.544635731
08/03/2000,8,Jordan,Jordan,Lebanon,Lebanon,1,1,Friendly,Amman,Jordan,2000,0,3,0,0,0,2,draw,draw,937,6,1,1,0.32521089,0.280182864
10/03/2000,10,Qatar,Qatar,Sudan,Sudan,3,0,Friendly,Doha,Qatar,2000,0,3,3,-3,3,3,winner,loser,938,6,1,1,0.90687339,0.682786997
13/03/2000,13,Jordan,Jordan,Syria,Syria,0,0,Friendly,Amman,Jordan,2000,0,3,0,0,0,0,draw,draw,939,6,1,0,0.68222432,0.967812362
17/03/2000,17,Jordan,Jordan,Syria,Syria,0,0,Friendly,Amman,Jordan,2000,0,3,0,0,0,0,draw,draw,940,6,1,0,0.74809291,0.350173223
22/03/2000,22,Bahrain,Bahrain,Qatar,Qatar,1,0,Friendly,Manama,Bahrain,2000,0,3,1,-1,1,1,winner,loser,941,6,0,1,0.64409761,0.679621391
25/03/2000,25,Bahrain,Bahrain,Jordan,Jordan,1,1,Friendly,Manama,Bahrain,2000,0,3,0,0,0,2,draw,draw,942,6,0,1,0.70206657,0.740924757
31/03/2000,31,Qatar,Qatar,Palestine,Palestine,1,0,AFC Asian Cup qualification,Doha,Qatar,2000,0,3,1,-1,1,1,winner,loser,943,6,1,0,0.11651899,0.418743668
31/03/2000,31,Syria,Syria,Bahrain,Bahrain,1,0,AFC Asian Cup qualification,Damascus,Syria,2000,0,3,1,-1,1,1,winner,loser,944,6,0,0,0.26924035,0.330698177
04/04/2000,4,Palestine,Palestine,Jordan,Jordan,1,5,AFC Asian Cup qualification,Doha,Qatar,2000,0,4,-4,4,4,6,loser,winner,945,6,0,1,0.27501509,0.206771513
07/04/2000,7,Mauritania,Mauritania,Tunisia,Tunisia,1,2,FIFA World Cup qualification,Nouakchott,Mauritania,2000,0,4,-1,1,1,3,loser,winner,946,6,1,1,0.00957586,0.444289352
08/04/2000,8,Qatar,Qatar,Jordan,Jordan,2,2,AFC Asian Cup qualification,Doha,Qatar,2000,0,4,0,0,0,4,draw,draw,947,6,1,1,0.76531441,0.865790324
13/04/2000,13,Bahrain,Bahrain,Syria,Syria,0,1,AFC Asian Cup qualification,Teheran,Iran,2000,0,4,-1,1,1,1,loser,winner,948,6,0,0,0.98628198,0.632627215
22/04/2000,22,Tunisia,Tunisia,Mauritania,Mauritania,3,0,FIFA World Cup qualification,Tunis,Tunisia,2000,0,4,3,-3,3,3,winner,loser,949,6,1,1,0.37119643,0.702800536
13/05/2000,13,Jordan,Jordan,Lebanon,Lebanon,1,1,Friendly,Limassol,Cyprus,2000,0,5,0,0,0,2,draw,draw,950,6,1,1,0.36286022,0.334222467
25/03/1972,25,Bahrain,Bahrain,UAE,UAE,2,0,Gulf Cup,Riyadh,Saudi Arabia,1972,2,3,2,-2,2,2,winner,loser,157,3,0,0,0.43564554,0.575194392
23/05/2000,23,Lebanon,Lebanon,Iraq,Iraq,1,2,WAFF Championship,Amman,Jordan,2000,0,5,-1,1,1,3,loser,winner,952,6,1,0,0.73309144,0.537960395
24/05/2000,24,Syria,Syria,Palestine,Palestine,1,0,WAFF Championship,Amman,Jordan,2000,0,5,1,-1,1,1,winner,loser,953,6,0,0,0.69348482,0.915724158
25/05/2000,25,Jordan,Jordan,Iraq,Iraq,0,0,WAFF Championship,Amman,Jordan,2000,0,5,0,0,0,0,draw,draw,954,6,1,0,0.47565034,0.932936519
27/05/2000,27,Jordan,Jordan,Lebanon,Lebanon,0,0,WAFF Championship,Amman,Jordan,2000,0,5,0,0,0,0,draw,draw,955,6,1,1,0.35745293,0.71154567
31/05/2000,31,Iraq,Iraq,Syria,Syria,0,0,WAFF Championship,Amman,Jordan,2000,0,5,0,0,0,0,draw,draw,956,6,0,0,0.05027923,0.180582976
02/06/2000,2,Jordan,Jordan,Iraq,Iraq,1,4,WAFF Championship,Amman,Jordan,2000,0,6,-3,3,3,5,loser,winner,957,6,1,0,0.75859614,0.614924907
25/06/2000,25,Lebanon,Lebanon,Kuwait,Kuwait,3,1,Friendly,Tripoli,Lebanon,2000,0,6,2,-2,2,4,winner,loser,958,6,1,0,0.42061926,0.538985069
28/06/2000,28,Tunisia,Tunisia,Algeria,Algeria,2,2,Friendly,Tunis,Tunisia,2000,0,6,0,0,0,4,draw,draw,959,6,1,1,0.73534248,0.325331406
09/07/2000,9,Morocco,Morocco,Algeria,Algeria,2,1,FIFA World Cup qualification,Fès,Morocco,2000,0,7,1,-1,1,3,winner,loser,960,6,0,1,0.38567585,0.0569053
05/08/2000,5,Lebanon,Lebanon,Oman,Oman,3,1,Friendly,Zahlé,Lebanon,2000,0,8,2,-2,2,4,winner,loser,961,6,1,1,0.47824406,0.433890833
08/08/2000,8,Lebanon,Lebanon,Oman,Oman,1,2,Friendly,Zahlé,Lebanon,2000,0,8,-1,1,1,3,loser,winner,962,6,1,1,0.71597262,0.815975089
09/08/2000,9,Syria,Syria,Bahrain,Bahrain,1,0,Friendly,Latakia,Syria,2000,0,8,1,-1,1,1,winner,loser,963,6,0,0,0.04921961,0.623827654
11/08/2000,11,Bahrain,Bahrain,Jordan,Jordan,0,2,Friendly,Latakia,Syria,2000,0,8,-2,2,2,2,loser,winner,964,6,0,1,0.30616254,0.829417455
13/08/2000,13,Syria,Syria,Jordan,Jordan,1,0,Friendly,Latakia,Syria,2000,0,8,1,-1,1,1,winner,loser,965,6,0,1,0.30508218,0.88879254
11/08/1973,11,Libya,Libya,UAE,UAE,2,2,Friendly,Benghazi,Libya,1973,3,8,0,0,0,4,draw,draw,168,3,0,0,0.14711483,0.355202932
13/08/1973,13,Algeria,Algeria,UAE,UAE,2,0,Friendly,Benghazi,Libya,1973,3,8,2,-2,2,2,winner,loser,170,3,1,0,0.16139512,0.441927781
10/09/2000,10,Libya,Libya,Sudan,Sudan,1,0,African Cup of Nations qualification,Tripoli,Libya,2000,0,9,1,-1,1,1,winner,loser,968,6,0,1,0.57091802,0.97594157
24/09/2000,24,Qatar,Qatar,Kuwait,Kuwait,0,0,Friendly,Doha,Qatar,2000,0,9,0,0,0,0,draw,draw,969,6,1,0,0.44083625,0.460268924
05/07/2012,5,Saudi Arabia,Saudi_Arabia,Iraq,Iraq,0,1,UAFA Cup,Jeddah,Saudi Arabia,2012,2,7,-1,1,1,1,loser,winner,1602,7,0,0,0.19953124,0.88339867
06/01/2013,6,Saudi Arabia,Saudi_Arabia,Iraq,Iraq,0,2,Gulf Cup,Isa Town,Bahrain,2013,3,1,-2,2,2,2,loser,winner,1645,7,0,0,0.77413765,0.28845154
15/11/2013,15,Saudi Arabia,Saudi_Arabia,Iraq,Iraq,2,1,AFC Asian Cup qualification,Dammam,Saudi Arabia,2013,3,11,1,-1,1,3,winner,loser,1690,7,0,0,0.0422173,0.230697782
20/08/1973,20,Iraq,Iraq,UAE,UAE,3,1,Friendly,Benghazi,Libya,1973,3,8,2,-2,2,4,winner,loser,182,3,0,0,0.01026677,0.137308932
02/10/2000,2,Qatar,Qatar,Egypt,Egypt,0,1,Friendly,Doha,Qatar,2000,0,10,-1,1,1,1,loser,winner,974,6,1,1,0.32192501,0.521591746
14/10/2014,14,Saudi Arabia,Saudi_Arabia,Lebanon,Lebanon,1,1,Friendly,Jeddah,Saudi Arabia,2014,4,10,0,0,0,2,draw,draw,1720,7,0,1,0.43616975,0.746062058
08/10/2000,8,Sudan,Sudan,Egypt,Egypt,0,1,African Cup of Nations qualification,Khartoum,Sudan,2000,0,10,-1,1,1,1,loser,winner,976,6,1,1,0.96086726,0.6015728
15/10/2000,15,Lebanon,Lebanon,Iraq,Iraq,2,2,AFC Asian Cup,Beirut,Lebanon,2000,0,10,0,0,0,4,draw,draw,977,6,1,0,0.42042113,0.922200593
06/11/2014,6,Saudi Arabia,Saudi_Arabia,Palestine,Palestine,2,0,Friendly,Dammam,Saudi Arabia,2014,4,11,2,-2,2,2,winner,loser,1722,7,0,0,0.55539197,0.803281134
23/03/1974,23,Saudi Arabia,Saudi_Arabia,UAE,UAE,2,0,Gulf Cup,Kuwait City,Kuwait,1974,4,3,2,-2,2,2,winner,loser,203,3,0,0,0.71882319,0.376213825
29/10/2000,29,Oman,Oman,Yemen,Yemen,4,0,Friendly,Muscat,Oman,2000,0,10,4,-4,4,4,winner,loser,980,6,1,1,0.64024564,0.312193737
31/10/2000,31,Oman,Oman,Yemen,Yemen,4,0,Friendly,Muscat,Oman,2000,0,10,4,-4,4,4,winner,loser,981,6,1,1,0.19431829,0.420175901
19/11/2000,19,Djibouti,Djibouti,Somalia,Somalia,0,0,CECAFA Cup,Kampala,Uganda,2000,0,11,0,0,0,0,draw,draw,982,6,0,1,0.03993256,0.547611282
21/11/2000,21,Oman,Oman,Bahrain,Bahrain,2,1,Friendly,Muscat,Oman,2000,0,11,1,-1,1,3,winner,loser,983,6,1,0,0.62945282,0.005191339
22/11/2000,22,Morocco,Morocco,Libya,Libya,0,0,Friendly,Casablanca,Morocco,2000,0,11,0,0,0,0,draw,draw,984,6,0,0,0.81751781,0.712281671
15/03/1974,15,Kuwait,Kuwait,UAE,UAE,2,0,Gulf Cup,Kuwait City,Kuwait,1974,4,3,2,-2,2,2,winner,loser,196,3,0,0,0.91065788,0.136409132
12/01/2001,12,Qatar,Qatar,Kuwait,Kuwait,1,0,Friendly,Doha,Qatar,2001,1,1,1,-1,1,1,winner,loser,986,6,1,0,0.98077281,0.747409534
13/01/2001,13,Tunisia,Tunisia,Morocco,Morocco,0,1,African Cup of Nations qualification,Tunis,Tunisia,2001,1,1,-1,1,1,1,loser,winner,987,6,1,0,0.05022164,0.594271814
14/01/2001,14,Egypt,Egypt,Libya,Libya,4,0,African Cup of Nations qualification,Cairo,Egypt,2001,1,1,4,-4,4,4,winner,loser,988,6,1,0,0.92303273,0.722275569
17/01/2001,17,Kuwait,Kuwait,Syria,Syria,2,0,Friendly,Doha,Qatar,2001,1,1,2,-2,2,2,winner,loser,989,6,0,0,0.15627284,0.801210865
28/01/2001,28,Egypt,Egypt,Morocco,Morocco,0,0,FIFA World Cup qualification,Cairo,Egypt,2001,1,1,0,0,0,0,draw,draw,990,6,1,0,0.17008173,0.940207527
13/11/2014,13,Saudi Arabia,Saudi_Arabia,Qatar,Qatar,1,1,Gulf Cup,Riyadh,Saudi Arabia,2014,4,11,0,0,0,2,draw,draw,1725,7,0,1,0.01705925,0.201540214
31/01/2001,31,Lebanon,Lebanon,Iraq,Iraq,0,0,Friendly,Beirut,Lebanon,2001,1,1,0,0,0,0,draw,draw,992,6,1,0,0.05253973,0.411114847
03/02/2001,3,Bahrain,Bahrain,Kuwait,Kuwait,1,2,FIFA World Cup qualification,Singapore,Singapore,2001,1,2,-1,1,1,3,loser,winner,993,6,0,0,0.0183813,0.512684223
16/11/2014,16,Saudi Arabia,Saudi_Arabia,Bahrain,Bahrain,3,0,Gulf Cup,Riyadh,Saudi Arabia,2014,4,11,3,-3,3,3,winner,loser,1729,7,0,0,0.85814885,0.824368294
27/02/2001,27,Kuwait,Kuwait,Bahrain,Bahrain,0,1,FIFA World Cup qualification,Kuwait City,Kuwait,2001,1,2,-1,1,1,1,loser,winner,995,6,0,0,0.31057458,0.394891981
07/03/2001,7,Lebanon,Lebanon,Syria,Syria,2,2,Friendly,Tripoli,Lebanon,2001,1,3,0,0,0,4,draw,draw,996,6,1,0,0.48213877,0.81291789
08/03/2001,8,Palestine,Palestine,Qatar,Qatar,1,2,FIFA World Cup qualification,So Kon Po,Hong Kong,2001,1,3,-1,1,1,3,loser,winner,997,6,0,1,0.8039464,0.669664129
11/03/2001,11,Egypt,Egypt,Algeria,Algeria,5,2,FIFA World Cup qualification,Cairo,Egypt,2001,1,3,3,-3,3,7,winner,loser,998,6,1,1,0.30088051,0.57773608
23/03/2001,23,Libya,Libya,Egypt,Egypt,2,0,African Cup of Nations qualification,Tripoli,Libya,2001,1,3,2,-2,2,2,winner,loser,999,6,0,1,0.70590561,0.644686367
23/03/2001,23,Qatar,Qatar,Palestine,Palestine,2,1,FIFA World Cup qualification,Doha,Qatar,2001,1,3,1,-1,1,3,winner,loser,1000,6,1,0,0.55533094,0.584481127
24/03/2001,24,Morocco,Morocco,Tunisia,Tunisia,2,0,African Cup of Nations qualification,Rabat,Morocco,2001,1,3,2,-2,2,2,winner,loser,1001,6,0,1,0.33559922,0.827044274
18/03/1974,18,Bahrain,Bahrain,UAE,UAE,0,4,Gulf Cup,Kuwait City,Kuwait,1974,4,3,-4,4,4,4,loser,winner,199,3,0,0,0.22065246,0.598753002
04/04/2001,4,Lebanon,Lebanon,Bahrain,Bahrain,1,1,Friendly,Beirut,Lebanon,2001,1,4,0,0,0,2,draw,draw,1003,6,1,0,0.85506256,0.678755288
05/04/2001,5,Oman,Oman,Sudan,Sudan,0,1,Friendly,Muscat,Oman,2001,1,4,-1,1,1,1,loser,winner,1004,6,1,1,0.07890684,0.837461718
07/04/2001,7,Oman,Oman,Sudan,Sudan,1,1,Friendly,Muscat,Oman,2001,1,4,0,0,0,2,draw,draw,1005,6,1,1,0.38495163,0.401325753
16/04/2001,16,Bahrain,Bahrain,Oman,Oman,0,1,Friendly,Manama,Bahrain,2001,1,4,-1,1,1,1,loser,winner,1006,6,0,1,0.29341914,0.653277984
04/05/2001,4,Algeria,Algeria,Morocco,Morocco,1,2,FIFA World Cup qualification,Algiers,Algeria,2001,1,5,-1,1,1,3,loser,winner,1007,6,1,0,0.28473114,0.836067169
26/03/1974,26,Kuwait,Kuwait,UAE,UAE,6,0,Gulf Cup,Kuwait City,Kuwait,1974,4,3,6,-6,6,6,winner,loser,205,3,0,0,0.43498187,0.256558125
18/05/2001,18,Syria,Syria,Oman,Oman,3,3,FIFA World Cup qualification,Aleppo,Syria,2001,1,5,0,0,0,6,draw,draw,1009,6,0,1,0.52760783,0.592447443
19/11/2014,19,Saudi Arabia,Saudi_Arabia,Yemen,Yemen,1,0,Gulf Cup,Riyadh,Saudi Arabia,2014,4,11,1,-1,1,1,winner,loser,1734,7,0,1,0.67320855,0.590336271
25/05/2001,25,Oman,Oman,Syria,Syria,2,0,FIFA World Cup qualification,Muscat,Oman,2001,1,5,2,-2,2,2,winner,loser,1011,6,1,0,0.05772681,0.488169378
17/06/2001,17,Sudan,Sudan,Libya,Libya,1,0,African Cup of Nations qualification,Khartoum,Sudan,2001,1,6,1,-1,1,1,winner,loser,1012,6,1,0,0.55413835,0.016832542
30/06/2001,30,Morocco,Morocco,Egypt,Egypt,1,0,FIFA World Cup qualification,Rabat,Morocco,2001,1,6,1,-1,1,1,winner,loser,1013,6,0,1,0.85037667,0.210562416
21/07/2001,21,Algeria,Algeria,Egypt,Egypt,1,1,FIFA World Cup qualification,Annaba,Algeria,2001,1,7,0,0,0,2,draw,draw,1014,6,1,1,0.65021387,0.679580618
29/07/2001,29,Oman,Oman,Iraq,Iraq,1,0,Friendly,Muscat,Oman,2001,1,7,1,-1,1,1,winner,loser,1015,6,1,0,0.05169391,0.656592864
28/03/1974,28,Qatar,Qatar,UAE,UAE,1,1,Gulf Cup,Kuwait City,Kuwait,1974,4,3,0,0,0,2,draw,draw,207,3,1,0,0.24449581,0.494989671
26/11/2014,26,Saudi Arabia,Saudi_Arabia,Qatar,Qatar,1,2,Gulf Cup,Riyadh,Saudi Arabia,2014,4,11,-1,1,1,3,loser,winner,1741,7,0,1,0.61892247,0.862652872
30/03/2015,30,Saudi Arabia,Saudi_Arabia,Jordan,Jordan,2,1,Friendly,Dammam,Saudi Arabia,2015,5,3,1,-1,1,3,winner,loser,1759,7,0,1,0.16874528,0.368619177
10/08/2001,10,Qatar,Qatar,Bahrain,Bahrain,1,1,Friendly,Doha,Qatar,2001,1,8,0,0,0,2,draw,draw,1019,6,1,0,0.45343383,0.838700965
16/08/2001,16,Qatar,Qatar,Oman,Oman,0,0,FIFA World Cup qualification,Doha,Qatar,2001,1,8,0,0,0,0,draw,draw,1020,6,1,1,0.29789837,0.549507636
11/06/2015,11,Saudi Arabia,Saudi_Arabia,Palestine,Palestine,3,2,FIFA World Cup qualification,Dammam,Saudi Arabia,2015,5,6,1,-1,1,5,winner,loser,1766,7,0,0,0.18617559,0.704345646
23/08/2001,23,Bahrain,Bahrain,Iraq,Iraq,2,0,FIFA World Cup qualification,Riffa,Bahrain,2001,1,8,2,-2,2,2,winner,loser,1022,6,0,0,0.84825986,0.67920722
19/12/1975,19,Tunisia,Tunisia,UAE,UAE,3,0,Friendly,Tunis,Tunisia,1975,5,12,3,-3,3,3,winner,loser,249,3,1,0,0.62251717,0.017212418
21/12/1975,21,Iraq,Iraq,UAE,UAE,5,0,Friendly,Tunis,Tunisia,1975,5,12,5,-5,5,5,winner,loser,250,3,0,0,0.95698117,0.587312055
28/03/2017,28,Saudi Arabia,Saudi_Arabia,Iraq,Iraq,1,0,FIFA World Cup qualification,Jeddah,Saudi Arabia,2017,7,3,1,-1,1,1,winner,loser,1827,7,0,0,0.7595343,0.600696494
29/03/1976,29,Saudi Arabia,Saudi_Arabia,UAE,UAE,2,0,Gulf Cup,Doha,Qatar,1976,6,3,2,-2,2,2,winner,loser,271,3,0,0,0.48332162,0.192530074
14/09/2001,14,Qatar,Qatar,Iraq,Iraq,0,0,Friendly,Doha,Qatar,2001,1,9,0,0,0,0,draw,draw,1027,6,1,0,0.13851656,0.41970393
27/03/1976,27,Bahrain,Bahrain,UAE,UAE,3,2,Gulf Cup,Doha,Qatar,1976,6,3,1,-1,1,5,winner,loser,267,3,0,0,0.31720684,0.030383239
21/09/2001,21,Oman,Oman,Qatar,Qatar,0,3,FIFA World Cup qualification,Muscat,Oman,2001,1,9,-3,3,3,3,loser,winner,1029,6,1,1,0.46094218,0.057099384
28/09/2001,28,Iraq,Iraq,Bahrain,Bahrain,1,0,FIFA World Cup qualification,Baghdad,Iraq,2001,1,9,1,-1,1,1,winner,loser,1030,6,0,0,0.0034167,0.522810792
01/04/1976,1,Qatar,Qatar,UAE,UAE,3,1,Gulf Cup,Doha,Qatar,1976,6,4,2,-2,2,4,winner,loser,275,3,1,0,0.54433254,0.895352093
05/10/2001,5,Bahrain,Bahrain,Qatar,Qatar,1,0,Friendly,Manama,Bahrain,2001,1,10,1,-1,1,1,winner,loser,1032,6,0,1,0.17953429,0.878681402
03/04/1976,3,Kuwait,Kuwait,UAE,UAE,0,0,Gulf Cup,Doha,Qatar,1976,6,4,0,0,0,0,draw,draw,277,3,0,0,0.48882516,0.055504279
18/10/2001,18,Kuwait,Kuwait,Qatar,Qatar,0,1,Friendly,Kuwait City,Kuwait,2001,1,10,-1,1,1,1,loser,winner,1034,6,0,1,0.30260009,0.961672954
28/12/2017,28,Saudi Arabia,Saudi_Arabia,Oman,Oman,0,2,Gulf Cup,Kuwait City,Kuwait,2017,7,12,-2,2,2,2,loser,winner,1860,7,0,1,0.60320797,0.430808562
29/11/2001,29,Oman,Oman,Kuwait,Kuwait,1,1,Friendly,Muscat,Oman,2001,1,11,0,0,0,2,draw,draw,1036,6,1,0,0.57501004,0.112590471
13/12/2001,13,Bahrain,Bahrain,Oman,Oman,2,2,Friendly,Manama,Bahrain,2001,1,12,0,0,0,4,draw,draw,1037,6,0,1,0.09273301,0.121626027
23/12/2001,23,Oman,Oman,Syria,Syria,2,0,Friendly,Muscat,Oman,2001,1,12,2,-2,2,2,winner,loser,1038,6,1,0,0.95364073,0.776222663
25/12/2001,25,Oman,Oman,Syria,Syria,1,0,Friendly,Muscat,Oman,2001,1,12,1,-1,1,1,winner,loser,1039,6,1,0,0.3293332,0.52270651
29/12/2001,29,Kuwait,Kuwait,Syria,Syria,0,0,Friendly,Kuwait City,Kuwait,2001,1,12,0,0,0,0,draw,draw,1040,6,0,0,0.80598138,0.604109822
30/12/2001,30,Qatar,Qatar,Egypt,Egypt,2,2,Friendly,Doha,Qatar,2001,1,12,0,0,0,4,draw,draw,1041,6,1,1,0.60718305,0.948233948
31/12/2001,31,Kuwait,Kuwait,Syria,Syria,2,2,Friendly,Kuwait City,Kuwait,2001,1,12,0,0,0,4,draw,draw,1042,6,0,0,0.07605287,0.8943424
11/01/2002,11,Iraq,Iraq,Oman,Oman,2,0,Friendly,Doha,Qatar,2002,2,1,2,-2,2,2,winner,loser,1043,6,0,1,0.84100553,0.777702491
13/01/2002,13,Qatar,Qatar,Iraq,Iraq,1,3,Friendly,Doha,Qatar,2002,2,1,-2,2,2,4,loser,winner,1044,6,1,0,0.2318929,0.84403447
25/06/2018,25,Saudi Arabia,Saudi_Arabia,Egypt,Egypt,2,1,FIFA World Cup,Volgograd,Russia,2018,8,6,1,-1,1,3,winner,loser,1882,7,0,1,0.43795731,0.017023496
17/01/2002,17,Qatar,Qatar,Bahrain,Bahrain,1,0,Gulf Cup,Riyadh,Saudi Arabia,2002,2,1,1,-1,1,1,winner,loser,1046,6,1,0,0.70529716,0.553707527
15/10/2018,15,Saudi Arabia,Saudi_Arabia,Iraq,Iraq,1,1,Friendly,Riyadh,Saudi Arabia,2018,8,10,0,0,0,2,draw,draw,1891,7,0,0,0.09986017,0.485358118
19/01/2002,19,Kuwait,Kuwait,Oman,Oman,1,3,Gulf Cup,Riyadh,Saudi Arabia,2002,2,1,-2,2,2,4,loser,winner,1048,6,0,1,0.7255869,0.729776536
16/11/2018,16,Saudi Arabia,Saudi_Arabia,Yemen,Yemen,1,0,Friendly,Damman,Saudi Arabia,2018,8,11,1,-1,1,1,winner,loser,1893,7,0,1,0.99283552,0.136032711
17/01/2019,17,Saudi Arabia,Saudi_Arabia,Qatar,Qatar,0,2,AFC Asian Cup,Abu Dhabi,United Arab Emirates,2019,9,1,-2,2,2,2,loser,winner,1913,7,0,1,0.5482612,0.268225706
22/01/2002,22,Kuwait,Kuwait,Bahrain,Bahrain,0,0,Gulf Cup,Riyadh,Saudi Arabia,2002,2,1,0,0,0,0,draw,draw,1051,6,0,0,0.67644061,0.453438796
24/01/2002,24,Oman,Oman,Qatar,Qatar,1,2,Gulf Cup,Riyadh,Saudi Arabia,2002,2,1,-1,1,1,3,loser,winner,1052,6,1,1,0.49402561,0.695658669
27/11/2019,27,Saudi Arabia,Saudi_Arabia,Kuwait,Kuwait,1,3,Gulf Cup,Doha,Qatar,2019,9,11,-2,2,2,4,loser,winner,1942,7,0,0,0.69287384,0.662463808
25/01/2002,25,Egypt,Egypt,Tunisia,Tunisia,1,0,African Cup of Nations,Bamako,Mali,2002,2,1,1,-1,1,1,winner,loser,1054,6,1,1,0.24266241,0.141679091
26/01/2002,26,Kuwait,Kuwait,Qatar,Qatar,0,1,Gulf Cup,Riyadh,Saudi Arabia,2002,2,1,-1,1,1,1,loser,winner,1055,6,0,1,0.27248504,0.291371005
25/03/2021,25,Saudi Arabia,Saudi_Arabia,Kuwait,Kuwait,1,0,Friendly,Riyadh,Saudi Arabia,2021,1,3,1,-1,1,1,winner,loser,1965,8,0,0,0.20494842,0.542176249
30/03/2021,30,Saudi Arabia,Saudi_Arabia,Palestine,Palestine,5,0,FIFA World Cup qualification,Riyadh,Saudi Arabia,2021,1,3,5,-5,5,5,winner,loser,1971,8,0,0,0.30435937,0.936146534
06/04/1976,6,Iraq,Iraq,UAE,UAE,4,0,Gulf Cup,Doha,Qatar,1976,6,4,4,-4,4,4,winner,loser,281,3,0,0,0.45870357,0.657260036
30/01/2002,30,Bahrain,Bahrain,Oman,Oman,1,1,Gulf Cup,Riyadh,Saudi Arabia,2002,2,1,0,0,0,2,draw,draw,1059,6,0,1,0.30865374,0.798006366
05/06/2021,5,Saudi Arabia,Saudi_Arabia,Yemen,Yemen,3,0,FIFA World Cup qualification,Riyadh,Saudi Arabia,2021,1,6,3,-3,3,3,winner,loser,1974,8,0,1,0.61082792,0.335527646
19/07/2002,19,Iraq,Iraq,Syria,Syria,2,0,Friendly,Baghdad,Iraq,2002,2,7,2,-2,2,2,winner,loser,1061,6,0,0,0.06708397,0.029878165
22/07/2002,22,Iraq,Iraq,Syria,Syria,2,1,Friendly,Baghdad,Iraq,2002,2,7,1,-1,1,3,winner,loser,1062,6,0,0,0.75373601,0.59452582
19/08/2002,19,Jordan,Jordan,Sudan,Sudan,0,0,Friendly,Amman,Jordan,2002,2,8,0,0,0,0,draw,draw,1063,6,1,1,0.20940482,0.268175357
23/08/2002,23,Egypt,Egypt,Sudan,Sudan,3,0,Friendly,Cairo,Egypt,2002,2,8,3,-3,3,3,winner,loser,1064,6,1,1,0.66454711,0.872689821
27/08/2002,27,Egypt,Egypt,Libya,Libya,0,1,Friendly,Alexandria,Egypt,2002,2,8,-1,1,1,1,loser,winner,1065,6,1,0,0.49362543,0.102148531
30/08/2002,30,Syria,Syria,Palestine,Palestine,2,1,WAFF Championship,Damascus,Syria,2002,2,8,1,-1,1,3,winner,loser,1066,6,0,0,0.92502255,0.210288775
01/09/2002,1,Lebanon,Lebanon,Jordan,Jordan,0,1,WAFF Championship,Damascus,Syria,2002,2,9,-1,1,1,1,loser,winner,1067,6,1,1,0.85391951,0.176284333
01/09/2002,1,Palestine,Palestine,Iraq,Iraq,0,2,WAFF Championship,Damascus,Syria,2002,2,9,-2,2,2,2,loser,winner,1068,6,0,0,0.94206106,0.428505568
03/09/2002,3,Syria,Syria,Iraq,Iraq,0,1,WAFF Championship,Damascus,Syria,2002,2,9,-1,1,1,1,loser,winner,1069,6,0,0,0.04759549,0.140599089
05/09/2002,5,Syria,Syria,Jordan,Jordan,1,2,WAFF Championship,Damascus,Syria,2002,2,9,-1,1,1,3,loser,winner,1070,6,0,1,0.76984921,0.374809185
07/09/2002,7,Jordan,Jordan,Iraq,Iraq,2,3,WAFF Championship,Damascus,Syria,2002,2,9,-1,1,1,5,loser,winner,1071,6,1,0,0.23653665,0.192155756
10/04/1976,10,Oman,Oman,UAE,UAE,1,1,Gulf Cup,Doha,Qatar,1976,6,4,0,0,0,2,draw,draw,285,3,1,0,0.13808602,0.773485347
20/11/2002,20,Qatar,Qatar,Iraq,Iraq,2,1,Friendly,Doha,Qatar,2002,2,11,1,-1,1,3,winner,loser,1073,6,1,0,0.3877798,0.676204409
20/11/2002,20,Tunisia,Tunisia,Egypt,Egypt,0,0,Friendly,Tunis,Tunisia,2002,2,11,0,0,0,0,draw,draw,1074,6,1,1,0.7810246,0.829327799
23/11/2002,23,Bahrain,Bahrain,Iraq,Iraq,2,2,Friendly,Doha,Qatar,2002,2,11,0,0,0,4,draw,draw,1075,6,0,0,0.40746763,0.467816205
07/12/2002,7,Bahrain,Bahrain,Jordan,Jordan,0,3,Prime Minister's Cup,Riffa,Bahrain,2002,2,12,-3,3,3,3,loser,winner,1076,6,0,1,0.59412712,0.117883372
09/12/2002,9,Bahrain,Bahrain,Syria,Syria,2,3,Prime Minister's Cup,Riffa,Bahrain,2002,2,12,-1,1,1,5,loser,winner,1077,6,0,0,0.74666355,0.793026072
12/12/2002,12,Jordan,Jordan,Syria,Syria,3,0,Prime Minister's Cup,Riffa,Bahrain,2002,2,12,3,-3,3,3,winner,loser,1078,6,1,0,0.47497145,0.123822589
10/12/1967,10,Saudi Arabia,Saudi_Arabia,Tunisia,Tunisia,4,0,Friendly,Riyadh,Saudi Arabia,1967,7,12,4,-4,4,4,winner,loser,79,2,0,1,0.46202579,0.109978155
16/12/2002,16,Palestine,Palestine,Jordan,Jordan,1,1,UAFA Cup,Kuwait City,Kuwait,2002,2,12,0,0,0,2,draw,draw,1080,6,0,1,0.93009608,0.062336894
07/10/2015,7,South Sudan,South_Sudan,Mauritania,Mauritania,1,1,FIFA World Cup qualification,Juba,South Sudan,2015,5,10,0,0,0,2,draw,draw,1778,7,0,1,0.60706761,0.23367682
23/11/2015,23,South Sudan,South_Sudan,Djibouti,Djibouti,2,0,CECAFA Cup,Bahir Dar,Ethiopia,2015,5,11,2,-2,2,2,winner,loser,1788,7,0,0,0.05821108,0.637056961
17/12/2002,17,Yemen,Yemen,Syria,Syria,0,4,UAFA Cup,Kuwait City,Kuwait,2002,2,12,-4,4,4,4,loser,winner,1083,6,1,0,0.00946994,0.157532544
18/12/2002,18,Kuwait,Kuwait,Sudan,Sudan,1,0,UAFA Cup,Kuwait City,Kuwait,2002,2,12,1,-1,1,1,winner,loser,1084,6,0,1,0.21989305,0.299183412
19/12/2002,19,Bahrain,Bahrain,Syria,Syria,2,0,UAFA Cup,Kuwait City,Kuwait,2002,2,12,2,-2,2,2,winner,loser,1085,6,0,0,0.5242554,0.224299698
25/11/2015,25,South Sudan,South_Sudan,Sudan,Sudan,0,0,CECAFA Cup,Bahir Dar,Ethiopia,2015,5,11,0,0,0,0,draw,draw,1789,7,0,1,0.34952098,0.221750751
20/12/2002,20,Jordan,Jordan,Sudan,Sudan,2,1,UAFA Cup,Kuwait City,Kuwait,2002,2,12,1,-1,1,3,winner,loser,1087,6,1,1,0.40319236,0.730292779
21/12/2002,21,Bahrain,Bahrain,Yemen,Yemen,3,1,UAFA Cup,Kuwait City,Kuwait,2002,2,12,2,-2,2,4,winner,loser,1088,6,0,1,0.1749586,0.461105705
21/12/2002,21,Syria,Syria,Lebanon,Lebanon,4,1,UAFA Cup,Kuwait City,Kuwait,2002,2,12,3,-3,3,5,winner,loser,1089,6,0,1,0.75541308,0.65161683
23/12/2002,23,Kuwait,Kuwait,Jordan,Jordan,1,2,UAFA Cup,Kuwait City,Kuwait,2002,2,12,-1,1,1,3,loser,winner,1090,6,0,1,0.0726946,0.210822018
23/12/2002,23,Sudan,Sudan,Palestine,Palestine,2,2,UAFA Cup,Kuwait City,Kuwait,2002,2,12,0,0,0,4,draw,draw,1091,6,1,0,0.32724659,0.711260325
24/12/2002,24,Lebanon,Lebanon,Yemen,Yemen,4,2,UAFA Cup,Kuwait City,Kuwait,2002,2,12,2,-2,2,6,winner,loser,1092,6,1,1,0.69061672,0.685784677
24/03/1979,24,Saudi Arabia,Saudi_Arabia,UAE,UAE,2,1,Gulf Cup,Baghdad,Iraq,1979,9,3,1,-1,1,3,winner,loser,333,3,0,0,0.45506355,0.81315599
25/12/2002,25,Kuwait,Kuwait,Palestine,Palestine,3,3,UAFA Cup,Kuwait City,Kuwait,2002,2,12,0,0,0,6,draw,draw,1094,6,0,0,0.74611289,0.538954349
26/12/2002,26,Lebanon,Lebanon,Bahrain,Bahrain,0,0,UAFA Cup,Kuwait City,Kuwait,2002,2,12,0,0,0,0,draw,draw,1095,6,1,0,0.62260494,0.645968447
27/03/1979,27,Bahrain,Bahrain,UAE,UAE,3,0,Gulf Cup,Baghdad,Iraq,1979,9,3,3,-3,3,3,winner,loser,335,3,0,0,0.1062396,0.727226065
28/12/2002,28,Jordan,Jordan,Bahrain,Bahrain,1,2,UAFA Cup,Kuwait City,Kuwait,2002,2,12,-1,1,1,3,loser,winner,1097,6,1,0,0.43063948,0.057986049
01/12/2015,1,South Sudan,South_Sudan,Sudan,Sudan,0,0,CECAFA Cup,Addis Abeba,Ethiopia,2015,5,12,0,0,0,0,draw,draw,1791,7,0,1,0.81503095,0.065753633
19/03/2003,19,Egypt,Egypt,Qatar,Qatar,6,0,Friendly,Port Said,Egypt,2003,3,3,6,-6,6,6,winner,loser,1099,6,1,1,0.2237867,0.282288929
22/08/2003,22,Lebanon,Lebanon,Syria,Syria,1,0,Friendly,Beirut,Lebanon,2003,3,8,1,-1,1,1,winner,loser,1100,6,1,0,0.31337549,0.34990783
26/08/2003,26,Jordan,Jordan,Iraq,Iraq,2,1,Friendly,Amman,Jordan,2003,3,8,1,-1,1,3,winner,loser,1101,6,1,0,0.5202534,0.535459361
04/09/2003,4,Algeria,Algeria,Qatar,Qatar,1,0,Friendly,Dinard,France,2003,3,9,1,-1,1,1,winner,loser,1102,6,1,1,0.71291658,0.789101907
10/09/2003,10,Oman,Oman,Bahrain,Bahrain,1,0,Friendly,Muscat,Oman,2003,3,9,1,-1,1,1,winner,loser,1103,6,1,0,0.80294279,0.263916334
14/09/2003,14,Kuwait,Kuwait,Qatar,Qatar,2,1,AFC Asian Cup qualification,Kuwait City,Kuwait,2003,3,9,1,-1,1,3,winner,loser,1104,6,0,1,0.75514737,0.240213492
17/09/2003,17,Yemen,Yemen,Sudan,Sudan,3,2,Friendly,Sana'a,Yemen,2003,3,9,1,-1,1,5,winner,loser,1105,6,1,1,0.96387342,0.34083049
19/09/2003,19,Bahrain,Bahrain,Lebanon,Lebanon,4,3,Friendly,Manama,Bahrain,2003,3,9,1,-1,1,7,winner,loser,1106,6,0,1,0.78577005,0.019429585
19/09/2003,19,Jordan,Jordan,Syria,Syria,0,0,Friendly,Amman,Jordan,2003,3,9,0,0,0,0,draw,draw,1107,6,1,0,0.53534713,0.474689417
19/09/2003,19,Yemen,Yemen,Sudan,Sudan,1,2,Friendly,Sana'a,Yemen,2003,3,9,-1,1,1,3,loser,winner,1108,6,1,1,0.57301231,0.522299589
20/09/2003,20,Qatar,Qatar,Kuwait,Kuwait,2,2,AFC Asian Cup qualification,Doha,Qatar,2003,3,9,0,0,0,4,draw,draw,1109,6,1,0,0.28470441,0.808549201
24/09/2003,24,Qatar,Qatar,Palestine,Palestine,1,1,AFC Asian Cup qualification,Doha,Qatar,2003,3,9,0,0,0,2,draw,draw,1110,6,1,0,0.2860164,0.503779922
27/09/2003,27,Qatar,Qatar,Palestine,Palestine,2,1,AFC Asian Cup qualification,Doha,Qatar,2003,3,9,1,-1,1,3,winner,loser,1111,6,1,0,0.3222563,0.621692646
27/09/2003,27,Syria,Syria,Yemen,Yemen,8,2,Friendly,Jeddah,Saudi Arabia,2003,3,9,6,-6,6,10,winner,loser,1112,6,0,1,0.81565683,0.47341561
28/03/2017,28,South Sudan,South_Sudan,Djibouti,Djibouti,6,0,African Cup of Nations qualification,Juba,South Sudan,2017,7,3,6,-6,6,6,winner,loser,1828,7,0,0,0.53162511,0.500475281
05/10/2003,5,Kuwait,Kuwait,Palestine,Palestine,2,1,AFC Asian Cup qualification,Kuwait City,Kuwait,2003,3,10,1,-1,1,3,winner,loser,1114,6,0,0,0.3058391,0.494648458
30/04/2017,30,South Sudan,South_Sudan,Somalia,Somalia,2,0,African Nations Championship,Juba,South Sudan,2017,7,4,2,-2,2,2,winner,loser,1830,7,0,1,0.74765517,0.674803335
08/10/2003,8,Iraq,Iraq,Bahrain,Bahrain,5,1,AFC Asian Cup qualification,Kuala Lumpur,Malaysia,2003,3,10,4,-4,4,6,winner,loser,1116,6,0,0,0.60166456,0.74904855
08/10/2003,8,Kuwait,Kuwait,Palestine,Palestine,4,0,AFC Asian Cup qualification,Kuwait City,Kuwait,2003,3,10,4,-4,4,4,winner,loser,1117,6,0,0,0.8660466,0.32516105
08/10/2003,8,Oman,Oman,Jordan,Jordan,2,1,Friendly,Muscat,Oman,2003,3,10,1,-1,1,3,winner,loser,1118,6,1,1,0.26151217,0.187646751
11/10/2003,11,Tunisia,Tunisia,Morocco,Morocco,0,0,Friendly,Tunis,Tunisia,2003,3,10,0,0,0,0,draw,draw,1119,6,1,0,0.33252954,0.263226266
29/12/1981,29,UAE,UAE,Tunisia,Tunisia,1,4,Friendly,al-Ain,United Arab Emirates,1981,1,12,-3,3,3,5,loser,winner,391,4,0,1,0.48431443,0.321161569
17/10/2003,17,Jordan,Jordan,Lebanon,Lebanon,1,0,AFC Asian Cup qualification,Amman,Jordan,2003,3,10,1,-1,1,1,winner,loser,1121,6,1,1,0.94103951,0.084205543
24/10/2003,24,Bahrain,Bahrain,Iraq,Iraq,1,0,AFC Asian Cup qualification,Riffa,Bahrain,2003,3,10,1,-1,1,1,winner,loser,1122,6,0,0,0.28892882,0.747413377
29/03/1979,29,Qatar,Qatar,UAE,UAE,1,0,Gulf Cup,Baghdad,Iraq,1979,9,3,1,-1,1,1,winner,loser,337,3,1,0,0.07666334,0.948228855
12/11/2003,12,Lebanon,Lebanon,Jordan,Jordan,0,2,AFC Asian Cup qualification,Beirut,Lebanon,2003,3,11,-2,2,2,2,loser,winner,1124,6,1,1,0.05557367,0.744159579
19/03/1982,19,UAE,UAE,Qatar,Qatar,1,0,Gulf Cup,Abu Dhabi,United Arab Emirates,1982,2,3,1,-1,1,1,winner,loser,395,4,0,1,0.55901213,0.13027911
12/12/2003,12,Bahrain,Bahrain,Iraq,Iraq,2,2,Prime Minister's Cup,Riffa,Bahrain,2003,3,12,0,0,0,4,draw,draw,1126,6,0,0,0.94490466,0.032150274
15/12/2003,15,Bahrain,Bahrain,Egypt,Egypt,0,1,Prime Minister's Cup,Riffa,Bahrain,2003,3,12,-1,1,1,1,loser,winner,1127,6,0,1,0.68612715,0.741831555
16/12/2003,16,Kuwait,Kuwait,Lebanon,Lebanon,2,0,Friendly,Paphos,Cyprus,2003,3,12,2,-2,2,2,winner,loser,1128,6,0,1,0.14134766,0.471931857
18/12/2003,18,Egypt,Egypt,Iraq,Iraq,2,0,Prime Minister's Cup,Riffa,Bahrain,2003,3,12,2,-2,2,2,winner,loser,1129,6,1,0,0.0506392,0.261613169
18/12/2003,18,Kuwait,Kuwait,Lebanon,Lebanon,0,0,Friendly,Paphos,Cyprus,2003,3,12,0,0,0,0,draw,draw,1130,6,0,1,0.13195878,0.107048818
21/12/2003,21,Qatar,Qatar,Iraq,Iraq,0,0,Friendly,Doha,Qatar,2003,3,12,0,0,0,0,draw,draw,1131,6,1,0,0.3738949,0.419231145
26/12/2003,26,Kuwait,Kuwait,Oman,Oman,0,0,Gulf Cup,Kuwait City,Kuwait,2003,3,12,0,0,0,0,draw,draw,1132,6,0,1,0.42540382,0.542509855
01/04/1979,1,Kuwait,Kuwait,UAE,UAE,7,0,Gulf Cup,Baghdad,Iraq,1979,9,4,7,-7,7,7,winner,loser,341,3,0,0,0.590435,0.497808409
27/12/2003,27,Bahrain,Bahrain,Qatar,Qatar,0,0,Gulf Cup,Kuwait City,Kuwait,2003,3,12,0,0,0,0,draw,draw,1134,6,0,1,0.89661089,0.704603025
28/12/2003,28,Yemen,Yemen,Oman,Oman,1,1,Gulf Cup,Kuwait City,Kuwait,2003,3,12,0,0,0,2,draw,draw,1135,6,1,1,0.52947843,0.70690523
04/04/1979,4,Iraq,Iraq,UAE,UAE,5,0,Gulf Cup,Baghdad,Iraq,1979,9,4,5,-5,5,5,winner,loser,345,3,0,0,0.9918606,0.761745706
24/03/1982,24,UAE,UAE,Kuwait,Kuwait,0,2,Gulf Cup,Abu Dhabi,United Arab Emirates,1982,2,3,-2,2,2,2,loser,winner,399,4,0,0,0.01222471,0.395006867
30/12/2003,30,Bahrain,Bahrain,Yemen,Yemen,5,1,Gulf Cup,Kuwait City,Kuwait,2003,3,12,4,-4,4,6,winner,loser,1138,6,0,1,0.99840272,0.12194288
09/04/1979,9,Oman,Oman,UAE,UAE,0,4,Gulf Cup,Baghdad,Iraq,1979,9,4,-4,4,4,4,loser,winner,351,3,1,0,0.55435568,0.405028116
15/09/1980,15,Kuwait,Kuwait,UAE,UAE,1,1,AFC Asian Cup,Kuwait City,Kuwait,1980,0,9,0,0,0,2,draw,draw,358,4,0,0,0.6573845,0.346476305
01/01/2004,1,Kuwait,Kuwait,Yemen,Yemen,4,0,Gulf Cup,Kuwait City,Kuwait,2004,4,1,4,-4,4,4,winner,loser,1141,6,0,1,0.03619355,0.332500551
03/01/2004,3,Oman,Oman,Bahrain,Bahrain,0,1,Gulf Cup,Kuwait City,Kuwait,2004,4,1,-1,1,1,1,loser,winner,1142,6,1,0,0.36910879,0.387854968
27/03/1982,27,UAE,UAE,Bahrain,Bahrain,2,3,Gulf Cup,Abu Dhabi,United Arab Emirates,1982,2,3,-1,1,1,5,loser,winner,402,4,0,0,0.11782735,0.362297331
17/09/1980,17,Qatar,Qatar,UAE,UAE,2,1,AFC Asian Cup,Kuwait City,Kuwait,1980,0,9,1,-1,1,3,winner,loser,359,4,1,0,0.85634437,0.588836076
05/01/2004,5,Qatar,Qatar,Yemen,Yemen,3,0,Gulf Cup,Kuwait City,Kuwait,2004,4,1,3,-3,3,3,winner,loser,1145,6,1,1,0.03065545,0.568204437
23/03/1984,23,Saudi Arabia,Saudi_Arabia,UAE,UAE,2,0,Gulf Cup,Muscat,Oman,1984,4,3,2,-2,2,2,winner,loser,439,4,0,0,0.51006959,0.107259974
02/04/1982,2,UAE,UAE,Oman,Oman,3,1,Gulf Cup,Abu Dhabi,United Arab Emirates,1982,2,4,2,-2,2,4,winner,loser,408,4,0,1,0.92836621,0.089282599
08/01/2004,8,Kuwait,Kuwait,Qatar,Qatar,1,2,Gulf Cup,Kuwait City,Kuwait,2004,4,1,-1,1,1,3,loser,winner,1148,6,0,1,0.85181782,0.085380037
22/10/1984,22,Saudi Arabia,Saudi_Arabia,UAE,UAE,1,0,AFC Asian Cup qualification,Jeddah,Saudi Arabia,1984,4,10,1,-1,1,1,winner,loser,445,4,0,0,0.4023311,0.638725553
10/01/2004,10,Kuwait,Kuwait,Bahrain,Bahrain,0,4,Gulf Cup,Kuwait City,Kuwait,2004,4,1,-4,4,4,4,loser,winner,1150,6,0,0,0.31489517,0.05395741
11/01/2004,11,Oman,Oman,Qatar,Qatar,2,0,Gulf Cup,Kuwait City,Kuwait,2004,4,1,2,-2,2,2,winner,loser,1151,6,1,1,0.49361304,0.175415511
12/04/1985,12,Saudi Arabia,Saudi_Arabia,UAE,UAE,0,0,FIFA World Cup qualification,Riyadh,Saudi Arabia,1985,5,4,0,0,0,0,draw,draw,479,4,0,0,0.5545016,0.260326343
29/01/2004,29,Algeria,Algeria,Egypt,Egypt,2,1,African Cup of Nations,Sousse,Tunisia,2004,4,1,1,-1,1,3,winner,loser,1153,6,1,1,0.22459756,0.206060702
08/02/2004,8,Lebanon,Lebanon,Bahrain,Bahrain,2,1,Friendly,Beirut,Lebanon,2004,4,2,1,-1,1,3,winner,loser,1154,6,1,0,0.59918721,0.050448019
08/02/2004,8,Morocco,Morocco,Algeria,Algeria,3,1,African Cup of Nations,Sfax,Tunisia,2004,4,2,2,-2,2,4,winner,loser,1155,6,0,1,0.69497706,0.159750682
13/02/2004,13,Qatar,Qatar,Bahrain,Bahrain,2,0,Friendly,Doha,Qatar,2004,4,2,2,-2,2,2,winner,loser,1156,6,1,0,0.43938341,0.724798123
14/02/2004,14,Tunisia,Tunisia,Morocco,Morocco,2,1,African Cup of Nations,Radès,Tunisia,2004,4,2,1,-1,1,3,winner,loser,1157,6,1,0,0.90914133,0.569398953
18/02/2004,18,Bahrain,Bahrain,Syria,Syria,2,1,FIFA World Cup qualification,Muharraq,Bahrain,2004,4,2,1,-1,1,3,winner,loser,1158,6,0,0,0.34319714,0.496384561
21/03/2004,21,Bahrain,Bahrain,Jordan,Jordan,0,0,Friendly,Muharraq,Bahrain,2004,4,3,0,0,0,0,draw,draw,1159,6,0,1,0.5298996,0.755966225
23/03/2004,23,Bahrain,Bahrain,Jordan,Jordan,0,2,Friendly,Muharraq,Bahrain,2004,4,3,-2,2,2,2,loser,winner,1160,6,0,1,0.4876253,0.938298702
23/03/2004,23,Lebanon,Lebanon,Syria,Syria,0,1,Friendly,Jounieh,Lebanon,2004,4,3,-1,1,1,1,loser,winner,1161,6,1,0,0.2283736,0.707617175
26/03/2004,26,Libya,Libya,Qatar,Qatar,1,0,Friendly,Rome,Italy,2004,4,3,1,-1,1,1,winner,loser,1162,6,0,1,0.05159513,0.443835794
26/03/2004,26,Syria,Syria,Palestine,Palestine,1,1,Friendly,Damascus,Syria,2004,4,3,0,0,0,2,draw,draw,1163,6,0,0,0.13677928,0.73098089
31/03/2004,31,Jordan,Jordan,Qatar,Qatar,1,0,FIFA World Cup qualification,Amman,Jordan,2004,4,3,1,-1,1,1,winner,loser,1164,6,1,1,0.55407743,0.204229239
31/03/2004,31,Palestine,Palestine,Iraq,Iraq,1,1,FIFA World Cup qualification,al-Wakrah,Qatar,2004,4,3,0,0,0,2,draw,draw,1165,6,0,0,0.25654779,0.074844024
19/04/2004,19,Sudan,Sudan,Syria,Syria,1,2,Friendly,Khartoum,Sudan,2004,4,4,-1,1,1,3,loser,winner,1166,6,1,0,0.90314727,0.448411064
21/04/2004,21,Sudan,Sudan,Syria,Syria,0,0,Friendly,Khartoum,Sudan,2004,4,4,0,0,0,0,draw,draw,1167,6,1,0,0.59975955,0.266306086
30/04/2004,30,Libya,Libya,Jordan,Jordan,1,0,Friendly,Lagos,Nigeria,2004,4,4,1,-1,1,1,winner,loser,1168,6,0,1,0.12624308,0.321666711
26/05/2004,26,Lebanon,Lebanon,Bahrain,Bahrain,2,2,Friendly,Beirut,Lebanon,2004,4,5,0,0,0,4,draw,draw,1169,6,1,0,0.04770735,0.259431604
30/05/2004,30,Algeria,Algeria,Jordan,Jordan,1,1,Friendly,Annaba,Algeria,2004,4,5,0,0,0,2,draw,draw,1170,6,1,1,0.66782385,0.697631224
24/10/1984,24,UAE,UAE,Oman,Oman,8,0,AFC Asian Cup qualification,Jeddah,Saudi Arabia,1984,4,10,8,-8,8,8,winner,loser,446,4,0,1,0.08190643,0.598392455
01/06/2004,1,Kuwait,Kuwait,Syria,Syria,0,1,Friendly,Kuwait City,Kuwait,2004,4,6,-1,1,1,1,loser,winner,1172,6,0,0,0.75233333,0.477314662
03/06/2004,3,Kuwait,Kuwait,Syria,Syria,1,2,Friendly,Kuwait City,Kuwait,2004,4,6,-1,1,1,3,loser,winner,1173,6,0,0,0.02419633,0.535003708
06/06/2004,6,Sudan,Sudan,Egypt,Egypt,0,3,FIFA World Cup qualification,Khartoum,Sudan,2004,4,6,-3,3,3,3,loser,winner,1174,6,1,1,0.24226843,0.748639109
25/11/1984,25,UAE,UAE,Syria,Syria,2,1,Friendly,Abu Dhabi,United Arab Emirates,1984,4,11,1,-1,1,3,winner,loser,448,4,0,0,0.74591986,0.684879069
17/06/2004,17,Palestine,Palestine,Jordan,Jordan,1,1,WAFF Championship,Teheran,Iran,2004,4,6,0,0,0,2,draw,draw,1176,6,0,1,0.4029016,0.625405266
19/06/2004,19,Iraq,Iraq,Palestine,Palestine,2,1,WAFF Championship,Teheran,Iran,2004,4,6,1,-1,1,3,winner,loser,1177,6,0,0,0.82886265,0.343872831
19/06/2004,19,Syria,Syria,Lebanon,Lebanon,3,1,WAFF Championship,Teheran,Iran,2004,4,6,2,-2,2,4,winner,loser,1178,6,0,1,0.97231356,0.946681143
21/06/2004,21,Jordan,Jordan,Iraq,Iraq,2,0,WAFF Championship,Teheran,Iran,2004,4,6,2,-2,2,2,winner,loser,1179,6,1,0,0.78790666,0.206643298
23/06/2004,23,Jordan,Jordan,Syria,Syria,1,1,WAFF Championship,Teheran,Iran,2004,4,6,0,0,0,2,draw,draw,1180,6,1,0,0.60518838,0.762419723
25/06/2004,25,Iraq,Iraq,Jordan,Jordan,1,3,WAFF Championship,Teheran,Iran,2004,4,6,-2,2,2,4,loser,winner,1181,6,0,1,0.2170007,0.719500295
03/07/2004,3,Sudan,Sudan,Libya,Libya,0,1,FIFA World Cup qualification,Khartoum,Sudan,2004,4,7,-1,1,1,1,loser,winner,1182,6,1,0,0.70237195,0.739898534
10/03/1984,10,Kuwait,Kuwait,UAE,UAE,0,2,Gulf Cup,Muscat,Oman,1984,4,3,-2,2,2,2,loser,winner,422,4,0,0,0.5266692,0.277371426
21/07/2004,21,Bahrain,Bahrain,Qatar,Qatar,1,1,AFC Asian Cup,Beijing,China PR,2004,4,7,0,0,0,2,draw,draw,1184,6,0,1,0.13597592,0.801258726
23/07/2004,23,Jordan,Jordan,Kuwait,Kuwait,2,0,AFC Asian Cup,Jinan,China PR,2004,4,7,2,-2,2,2,winner,loser,1185,6,1,0,0.75951167,0.550468369
13/03/1984,13,Qatar,Qatar,UAE,UAE,0,1,Gulf Cup,Muscat,Oman,1984,4,3,-1,1,1,1,loser,winner,426,4,1,0,0.64639742,0.274757054
15/03/1984,15,Iraq,Iraq,UAE,UAE,0,0,Gulf Cup,Muscat,Oman,1984,4,3,0,0,0,0,draw,draw,427,4,0,0,0.74976361,0.743122385
26/08/2004,26,Bahrain,Bahrain,Kuwait,Kuwait,0,0,Friendly,Muharraq,Bahrain,2004,4,8,0,0,0,0,draw,draw,1188,6,0,0,0.20890179,0.964738827
26/08/2004,26,Yemen,Yemen,Syria,Syria,1,2,Friendly,Sana'a,Yemen,2004,4,8,-1,1,1,3,loser,winner,1189,6,1,0,0.87122795,0.646963301
28/08/2004,28,Yemen,Yemen,Syria,Syria,2,1,Friendly,Sana'a,Yemen,2004,4,8,1,-1,1,3,winner,loser,1190,6,1,0,0.51650702,0.758748118
31/08/2004,31,Jordan,Jordan,Lebanon,Lebanon,2,2,Friendly,Amman,Jordan,2004,4,8,0,0,0,4,draw,draw,1191,6,1,1,0.17315314,0.894446306
20/09/1985,20,UAE,UAE,Iraq,Iraq,2,3,FIFA World Cup qualification,Dubai,United Arab Emirates,1985,5,9,-1,1,1,5,loser,winner,502,4,0,0,0.47508905,0.264194528
02/09/2004,2,Bahrain,Bahrain,Palestine,Palestine,1,0,Friendly,Muharraq,Bahrain,2004,4,9,1,-1,1,1,winner,loser,1193,6,0,0,0.27331661,0.121372027
04/09/2004,4,Morocco,Morocco,Tunisia,Tunisia,1,1,FIFA World Cup qualification,Rabat,Morocco,2004,4,9,0,0,0,2,draw,draw,1194,6,0,1,0.21442006,0.644645753
18/03/1984,18,Bahrain,Bahrain,UAE,UAE,1,1,Gulf Cup,Muscat,Oman,1984,4,3,0,0,0,2,draw,draw,432,4,0,0,0.31537336,0.805371861
29/09/2004,29,Kuwait,Kuwait,Syria,Syria,1,1,Friendly,Tripoli,Lebanon,2004,4,9,0,0,0,2,draw,draw,1196,6,0,0,0.83759935,0.694156744
03/10/2004,3,Lebanon,Lebanon,Kuwait,Kuwait,1,3,Friendly,Tripoli,Lebanon,2004,4,10,-2,2,2,4,loser,winner,1197,6,1,0,0.26826661,0.516006117
06/10/2004,6,Lebanon,Lebanon,Kuwait,Kuwait,1,1,Friendly,Beirut,Lebanon,2004,4,10,0,0,0,2,draw,draw,1198,6,1,0,0.82594028,0.52855046
24/03/1986,24,UAE,UAE,Iraq,Iraq,2,2,Gulf Cup,Riffa,Bahrain,1986,6,3,0,0,0,4,draw,draw,519,4,0,0,0.97913002,0.294568289
07/10/2004,7,Oman,Oman,Iraq,Iraq,1,0,Friendly,Muscat,Oman,2004,4,10,1,-1,1,1,winner,loser,1200,6,1,0,0.27475754,0.663455791
08/10/2004,8,Libya,Libya,Egypt,Egypt,2,1,FIFA World Cup qualification,Tripoli,Libya,2004,4,10,1,-1,1,3,winner,loser,1201,6,0,1,0.799942,0.171943465
08/10/2004,8,Qatar,Qatar,Syria,Syria,1,2,Friendly,Doha,Qatar,2004,4,10,-1,1,1,3,loser,winner,1202,6,1,0,0.60461432,0.534174396
13/10/2004,13,Syria,Syria,Bahrain,Bahrain,2,2,FIFA World Cup qualification,Damascus,Syria,2004,4,10,0,0,0,4,draw,draw,1203,6,0,0,0.01678367,0.160878056
22/10/2004,22,Libya,Libya,Jordan,Jordan,1,0,Friendly,Tripoli,Libya,2004,4,10,1,-1,1,1,winner,loser,1204,6,0,1,0.58281898,0.146754266
28/03/1986,28,UAE,UAE,Kuwait,Kuwait,0,1,Gulf Cup,Manama,Bahrain,1986,6,3,-1,1,1,1,loser,winner,524,4,0,0,0.46922619,0.908448824
16/11/2004,16,Iraq,Iraq,Palestine,Palestine,4,1,FIFA World Cup qualification,Doha,Qatar,2004,4,11,3,-3,3,5,winner,loser,1206,6,0,0,0.44421804,0.44528402
17/11/2004,17,Qatar,Qatar,Jordan,Jordan,2,0,FIFA World Cup qualification,Doha,Qatar,2004,4,11,2,-2,2,2,winner,loser,1207,6,1,1,0.91704338,0.880819466
19/03/1987,19,UAE,UAE,Syria,Syria,1,1,Friendly,Abu Dhabi,United Arab Emirates,1987,7,3,0,0,0,2,draw,draw,543,4,0,0,0.68617377,0.568087415
01/12/2004,1,Qatar,Qatar,Lebanon,Lebanon,4,1,Friendly,Doha,Qatar,2004,4,12,3,-3,3,5,winner,loser,1209,6,1,1,0.20751159,0.431211336
03/12/2004,3,Iraq,Iraq,Yemen,Yemen,3,1,Friendly,Dubai,United Arab Emirates,2004,4,12,2,-2,2,4,winner,loser,1210,6,0,1,0.89881135,0.106667176
23/03/1987,23,UAE,UAE,Syria,Syria,2,1,Friendly,Abu Dhabi,United Arab Emirates,1987,7,3,1,-1,1,3,winner,loser,544,4,0,0,0.48275977,0.269986411
05/12/2004,5,Qatar,Qatar,Yemen,Yemen,3,0,Friendly,Doha,Qatar,2004,4,12,3,-3,3,3,winner,loser,1212,6,1,1,0.3640289,0.105074474
10/12/2004,10,Iraq,Iraq,Oman,Oman,1,3,Gulf Cup,Doha,Qatar,2004,4,12,-2,2,2,4,loser,winner,1213,6,0,1,0.11649482,0.816018658
21/03/1984,21,Oman,Oman,UAE,UAE,1,1,Gulf Cup,Muscat,Oman,1984,4,3,0,0,0,2,draw,draw,436,4,1,0,0.22584752,0.076904116
11/12/2004,11,Bahrain,Bahrain,Yemen,Yemen,1,1,Gulf Cup,Rayyan,Qatar,2004,4,12,0,0,0,2,draw,draw,1215,6,0,1,0.39814014,0.566208232
07/02/1988,7,UAE,UAE,Yemen,Yemen,2,1,AFC Asian Cup qualification,Abu Dhabi,United Arab Emirates,1988,8,2,1,-1,1,3,winner,loser,554,4,0,1,0.08659214,0.404399547
02/04/1985,2,Syria,Syria,UAE,UAE,2,1,Friendly,Manama,Bahrain,1985,5,4,1,-1,1,3,winner,loser,471,4,0,0,0.75904613,0.270401197
13/12/2004,13,Qatar,Qatar,Iraq,Iraq,3,3,Gulf Cup,Doha,Qatar,2004,4,12,0,0,0,6,draw,draw,1218,6,1,0,0.10666051,0.557481482
14/12/2004,14,Kuwait,Kuwait,Bahrain,Bahrain,1,1,Gulf Cup,Rayyan,Qatar,2004,4,12,0,0,0,2,draw,draw,1219,6,0,0,0.41905154,0.146033097
23/02/1988,23,UAE,UAE,Egypt,Egypt,1,2,Friendly,Dubai,United Arab Emirates,1988,8,2,-1,1,1,3,loser,winner,555,4,0,1,0.38314384,0.207984265
05/04/1985,5,Bahrain,Bahrain,UAE,UAE,3,2,Friendly,Manama,Bahrain,1985,5,4,1,-1,1,5,winner,loser,472,4,0,0,0.57218863,0.56224539
16/12/2004,16,Qatar,Qatar,Oman,Oman,2,1,Gulf Cup,Doha,Qatar,2004,4,12,1,-1,1,3,winner,loser,1222,6,1,1,0.00122169,0.716651669
07/04/1985,7,Syria,Syria,UAE,UAE,0,4,Friendly,Manama,Bahrain,1985,5,4,-4,4,4,4,loser,winner,475,4,0,0,0.65806295,0.358540216
17/12/2004,17,Kuwait,Kuwait,Yemen,Yemen,3,0,Gulf Cup,Doha,Qatar,2004,4,12,3,-3,3,3,winner,loser,1224,6,0,1,0.1805249,0.57857537
18/12/2004,18,Sudan,Sudan,Somalia,Somalia,4,0,CECAFA Cup,Addis Abeba,Ethiopia,2004,4,12,4,-4,4,4,winner,loser,1225,6,1,1,0.3627501,0.776049707
20/12/2004,20,Oman,Oman,Bahrain,Bahrain,3,2,Gulf Cup,Rayyan,Qatar,2004,4,12,1,-1,1,5,winner,loser,1226,6,1,0,0.21714242,0.791202511
20/12/2004,20,Qatar,Qatar,Kuwait,Kuwait,2,0,Gulf Cup,Doha,Qatar,2004,4,12,2,-2,2,2,winner,loser,1227,6,1,0,0.36462073,0.844002616
23/12/2004,23,Bahrain,Bahrain,Kuwait,Kuwait,3,1,Gulf Cup,Doha,Qatar,2004,4,12,2,-2,2,4,winner,loser,1228,6,0,0,0.4821414,0.839010146
24/12/2004,24,Qatar,Qatar,Oman,Oman,1,1,Gulf Cup,Doha,Qatar,2004,4,12,0,0,0,2,draw,draw,1229,6,1,1,0.30767428,0.869156135
26/01/2005,26,Kuwait,Kuwait,Syria,Syria,3,2,Friendly,Kuwait City,Kuwait,2005,5,1,1,-1,1,5,winner,loser,1230,6,0,0,0.37264829,0.588005261
02/02/2005,2,Bahrain,Bahrain,Lebanon,Lebanon,2,1,Friendly,Doha,Qatar,2005,5,2,1,-1,1,3,winner,loser,1231,6,0,1,0.2967194,0.351004029
26/02/1988,26,UAE,UAE,Egypt,Egypt,1,1,Friendly,Abu Dhabi,United Arab Emirates,1988,8,2,0,0,0,2,draw,draw,558,4,0,1,0.80676434,0.556003986
27/03/2005,27,Egypt,Egypt,Libya,Libya,4,1,FIFA World Cup qualification,Cairo,Egypt,2005,5,3,3,-3,3,5,winner,loser,1233,6,1,0,0.51061279,0.997062547
02/04/1986,2,Saudi Arabia,Saudi_Arabia,UAE,UAE,0,2,Gulf Cup,Riffa,Bahrain,1986,6,4,-2,2,2,2,loser,winner,530,4,0,0,0.26403601,0.927158498
27/05/2005,27,Kuwait,Kuwait,Egypt,Egypt,0,1,Friendly,Kuwait City,Kuwait,2005,5,5,-1,1,1,1,loser,winner,1235,6,0,1,0.32278823,0.102222664
03/03/1988,3,UAE,UAE,Bahrain,Bahrain,2,0,Gulf Cup,Riyadh,Saudi Arabia,1988,8,3,2,-2,2,2,winner,loser,561,4,0,0,0.66725377,0.27918573
10/03/1988,10,UAE,UAE,Iraq,Iraq,0,0,Gulf Cup,Riyadh,Saudi Arabia,1988,8,3,0,0,0,0,draw,draw,570,4,0,0,0.80185921,0.057818457
05/06/2005,5,Egypt,Egypt,Sudan,Sudan,6,1,FIFA World Cup qualification,Cairo,Egypt,2005,5,6,5,-5,5,7,winner,loser,1238,6,1,1,0.91581997,0.9960219
08/06/2005,8,Jordan,Jordan,Iraq,Iraq,0,1,Friendly,Amman,Jordan,2005,5,6,-1,1,1,1,loser,winner,1239,6,1,0,0.39487331,0.975648702
13/03/1988,13,Saudi Arabia,Saudi_Arabia,UAE,UAE,2,2,Gulf Cup,Riyadh,Saudi Arabia,1988,8,3,0,0,0,4,draw,draw,573,4,0,0,0.82403638,0.461521079
27/09/1985,27,Iraq,Iraq,UAE,UAE,1,2,FIFA World Cup qualification,Ta'if,Saudi Arabia,1985,5,9,-1,1,1,3,loser,winner,503,4,0,0,0.31379908,0.028329741
07/08/2005,7,Bahrain,Bahrain,Iraq,Iraq,2,2,Friendly,Manama,Bahrain,2005,5,8,0,0,0,4,draw,draw,1242,6,0,0,0.12239679,0.679056978
02/09/2005,2,Libya,Libya,Sudan,Sudan,0,0,FIFA World Cup qualification,Tripoli,Libya,2005,5,9,0,0,0,0,draw,draw,1243,6,0,1,0.77390895,0.315144853
08/10/2005,8,Tunisia,Tunisia,Morocco,Morocco,2,2,FIFA World Cup qualification,Radès,Tunisia,2005,5,10,0,0,0,4,draw,draw,1244,6,1,0,0.69376897,0.480315
11/10/2005,11,Qatar,Qatar,Iraq,Iraq,0,0,Friendly,Doha,Qatar,2005,5,10,0,0,0,0,draw,draw,1245,6,1,0,0.35248626,0.363313014
17/03/1988,17,UAE,UAE,Oman,Oman,1,0,Gulf Cup,Riyadh,Saudi Arabia,1988,8,3,1,-1,1,1,winner,loser,578,4,0,1,0.36755674,0.222874651
25/10/2005,25,Oman,Oman,Syria,Syria,0,0,Friendly,Muscat,Oman,2005,5,10,0,0,0,0,draw,draw,1247,6,1,0,0.83239556,0.911514672
16/11/2005,16,Egypt,Egypt,Tunisia,Tunisia,1,2,Friendly,Cairo,Egypt,2005,5,11,-1,1,1,3,loser,winner,1248,6,1,1,0.71748127,0.015740894
30/03/1986,30,Oman,Oman,UAE,UAE,0,1,Gulf Cup,Riffa,Bahrain,1986,6,3,-1,1,1,1,loser,winner,527,4,1,0,0.57855804,0.83916645
26/11/2005,26,Kuwait,Kuwait,Iraq,Iraq,0,0,Friendly,Kuwait City,Kuwait,2005,5,11,0,0,0,0,draw,draw,1250,6,0,0,0.9504989,0.631518634
27/11/2005,27,Djibouti,Djibouti,Somalia,Somalia,1,2,CECAFA Cup,Kigali,Rwanda,2005,5,11,-1,1,1,3,loser,winner,1251,6,0,1,0.64568393,0.857939397
29/11/2005,29,Somalia,Somalia,Sudan,Sudan,1,4,CECAFA Cup,Kigali,Rwanda,2005,5,11,-3,3,3,5,loser,winner,1252,6,1,1,0.03012638,0.961361265
01/12/2005,1,Iraq,Iraq,Palestine,Palestine,4,0,Friendly,Rayyan,Qatar,2005,5,12,4,-4,4,4,winner,loser,1253,6,0,0,0.69056782,0.934994716
17/11/1988,17,UAE,UAE,Jordan,Jordan,2,1,Friendly,Sharjah,United Arab Emirates,1988,8,11,1,-1,1,3,winner,loser,610,4,0,1,0.48054195,0.62749569
03/12/2005,3,Oman,Oman,Syria,Syria,1,3,Friendly,Doha,Qatar,2005,5,12,-2,2,2,4,loser,winner,1255,6,1,0,0.34897294,0.462640912
20/11/1988,20,UAE,UAE,Jordan,Jordan,3,2,Friendly,Dubai,United Arab Emirates,1988,8,11,1,-1,1,5,winner,loser,611,4,0,1,0.95625366,0.144371414
04/12/2005,4,Bahrain,Bahrain,Syria,Syria,2,2,Friendly,Doha,Qatar,2005,5,12,0,0,0,4,draw,draw,1257,6,0,0,0.86303133,0.251448539
05/12/2005,5,Djibouti,Djibouti,Sudan,Sudan,0,4,CECAFA Cup,Kigali,Rwanda,2005,5,12,-4,4,4,4,loser,winner,1258,6,0,1,0.91292731,0.689346755
05/04/1986,5,Bahrain,Bahrain,UAE,UAE,1,3,Gulf Cup,Riffa,Bahrain,1986,6,4,-2,2,2,4,loser,winner,532,4,0,0,0.74992486,0.783968165
06/12/2005,6,Bahrain,Bahrain,Oman,Oman,2,2,Friendly,Doha,Qatar,2005,5,12,0,0,0,4,draw,draw,1260,6,0,1,0.09502589,0.754416225
07/04/1986,7,Qatar,Qatar,UAE,UAE,3,2,Gulf Cup,Riffa,Bahrain,1986,6,4,1,-1,1,5,winner,loser,536,4,1,0,0.6388293,0.308010851
10/12/2005,10,Syria,Syria,Iraq,Iraq,2,2,Friendly,Doha,Qatar,2005,5,12,0,0,0,4,draw,draw,1262,6,0,0,0.49359322,0.466228654
02/01/2006,2,Qatar,Qatar,Libya,Libya,2,0,Friendly,Doha,Qatar,2006,6,1,2,-2,2,2,winner,loser,1263,6,1,0,0.69691846,0.419649799
12/01/2006,12,Tunisia,Tunisia,Libya,Libya,1,0,Friendly,Tunis,Tunisia,2006,6,1,1,-1,1,1,winner,loser,1264,6,1,0,0.71968151,0.858151856
20/01/2006,20,Egypt,Egypt,Libya,Libya,3,0,African Cup of Nations,Cairo,Egypt,2006,6,1,3,-3,3,3,winner,loser,1265,6,1,0,0.1040227,0.02121208
24/01/2006,24,Egypt,Egypt,Morocco,Morocco,0,0,African Cup of Nations,Cairo,Egypt,2006,6,1,0,0,0,0,draw,draw,1266,6,1,0,0.17170294,0.389416908
24/11/1988,24,UAE,UAE,Algeria,Algeria,1,1,Friendly,Dubai,United Arab Emirates,1988,8,11,0,0,0,2,draw,draw,612,4,0,1,0.45715171,0.390828016
28/01/2006,28,Libya,Libya,Morocco,Morocco,0,0,African Cup of Nations,Cairo,Egypt,2006,6,1,0,0,0,0,draw,draw,1268,6,0,0,0.51030538,0.898869281
30/01/2006,30,Bahrain,Bahrain,Syria,Syria,1,1,Friendly,Manama,Bahrain,2006,6,1,0,0,0,2,draw,draw,1269,6,0,0,0.52078199,0.395760017
07/02/2006,7,Kuwait,Kuwait,Jordan,Jordan,2,1,Friendly,Kuwait City,Kuwait,2006,6,2,1,-1,1,3,winner,loser,1270,6,0,1,0.13695443,0.218454485
07/02/2006,7,Syria,Syria,Palestine,Palestine,3,0,Friendly,Aleppo,Syria,2006,6,2,3,-3,3,3,winner,loser,1271,6,0,0,0.51524619,0.751308197
13/02/2006,13,Oman,Oman,Iraq,Iraq,1,0,Friendly,Muscat,Oman,2006,6,2,1,-1,1,1,winner,loser,1272,6,1,0,0.37905341,0.282500093
03/02/1989,3,UAE,UAE,Kuwait,Kuwait,1,0,FIFA World Cup qualification,Sharjah,United Arab Emirates,1989,9,2,1,-1,1,1,winner,loser,634,4,0,0,0.41982505,0.802579993
16/02/2006,16,Bahrain,Bahrain,Palestine,Palestine,0,2,Friendly,Muharraq,Bahrain,2006,6,2,-2,2,2,2,loser,winner,1274,6,0,0,0.19105623,0.114038024
22/02/2006,22,Lebanon,Lebanon,Kuwait,Kuwait,1,1,AFC Asian Cup qualification,Beirut,Lebanon,2006,6,2,0,0,0,2,draw,draw,1275,6,1,0,0.82316429,0.99092054
24/10/1989,24,UAE,UAE,Qatar,Qatar,1,1,FIFA World Cup qualification,Singapore,Singapore,1989,9,10,0,0,0,2,draw,draw,655,4,0,1,0.2641633,0.030682022
21/10/1989,21,Saudi Arabia,Saudi_Arabia,UAE,UAE,0,0,FIFA World Cup qualification,Singapore,Singapore,1989,9,10,0,0,0,0,draw,draw,654,4,0,0,0.47767287,0.214872774
01/03/2006,1,Kuwait,Kuwait,Bahrain,Bahrain,0,0,AFC Asian Cup qualification,Kuwait City,Kuwait,2006,6,3,0,0,0,0,draw,draw,1278,6,0,0,0.71470354,0.837793698
01/03/2006,1,Oman,Oman,Jordan,Jordan,3,0,AFC Asian Cup qualification,Muscat,Oman,2006,6,3,3,-3,3,3,winner,loser,1279,6,1,1,0.82723328,0.068467362
25/01/1990,25,UAE,UAE,Egypt,Egypt,1,2,Friendly,Abu Dhabi,United Arab Emirates,1990,0,1,-1,1,1,3,loser,winner,662,5,0,1,0.16969401,0.516157039
27/01/1990,27,UAE,UAE,Egypt,Egypt,1,0,Friendly,Abu Dhabi,United Arab Emirates,1990,0,1,1,-1,1,1,winner,loser,663,5,0,1,0.12257405,0.921270145
04/06/2006,4,Algeria,Algeria,Sudan,Sudan,1,0,Friendly,Algiers,Algeria,2006,6,6,1,-1,1,1,winner,loser,1282,6,1,1,0.41214352,0.024406634
15/01/1988,15,Jordan,Jordan,UAE,UAE,0,1,Friendly,Manama,Bahrain,1988,8,1,-1,1,1,1,loser,winner,552,4,1,0,0.45853461,0.934607305
15/07/2006,15,Syria,Syria,Iraq,Iraq,1,3,Friendly,Damascus,Syria,2006,6,7,-2,2,2,4,loser,winner,1284,6,0,0,0.4431091,0.094431539
21/07/2006,21,Jordan,Jordan,Iraq,Iraq,2,1,Friendly,Amman,Jordan,2006,6,7,1,-1,1,3,winner,loser,1285,6,1,0,0.1226144,0.476640057
25/07/2006,25,Syria,Syria,Iraq,Iraq,1,2,Friendly,Damascus,Syria,2006,6,7,-1,1,1,3,loser,winner,1286,6,0,0,0.33212242,0.586354027
30/07/2006,30,Jordan,Jordan,Syria,Syria,3,0,Friendly,Amman,Jordan,2006,6,7,3,-3,3,3,winner,loser,1287,6,1,0,0.63416278,0.588825172
05/08/2006,5,Syria,Syria,Libya,Libya,2,1,Friendly,Damascus,Syria,2006,6,8,1,-1,1,3,winner,loser,1288,6,0,0,0.74762235,0.934150018
09/08/2006,9,Jordan,Jordan,Iraq,Iraq,0,1,Friendly,Amman,Jordan,2006,6,8,-1,1,1,1,loser,winner,1289,6,1,0,0.40075996,0.021383316
14/05/1992,14,UAE,UAE,Qatar,Qatar,1,0,Friendly,Abu Dhabi,United Arab Emirates,1992,2,5,1,-1,1,1,winner,loser,686,5,0,1,0.11891788,0.927819345
18/01/1988,18,Jordan,Jordan,UAE,UAE,2,0,Friendly,Manama,Bahrain,1988,8,1,2,-2,2,2,winner,loser,553,4,1,0,0.13567396,0.281306009
17/08/2006,17,Palestine,Palestine,Iraq,Iraq,0,3,AFC Asian Cup qualification,Amman,Jordan,2006,6,8,-3,3,3,3,loser,winner,1292,6,0,0,0.65168657,0.461008844
26/08/2006,26,Yemen,Yemen,Libya,Libya,0,1,Friendly,Sana'a,Yemen,2006,6,8,-1,1,1,1,loser,winner,1293,6,1,0,0.58105389,0.184381734
17/05/1992,17,UAE,UAE,Syria,Syria,2,0,Friendly,Al Ain,United Arab Emirates,1992,2,5,2,-2,2,2,winner,loser,688,5,0,0,0.461417,0.697170251
29/08/2006,29,Yemen,Yemen,Libya,Libya,1,1,Friendly,Sana'a,Yemen,2006,6,8,0,0,0,2,draw,draw,1295,6,1,0,0.23819901,0.171789876
01/09/2006,1,Oman,Oman,Syria,Syria,3,0,Friendly,Muscat,Oman,2006,6,9,3,-3,3,3,winner,loser,1296,6,1,0,0.99020067,0.430410168
02/09/2006,2,Bahrain,Bahrain,Jordan,Jordan,0,2,Friendly,Manama,Bahrain,2006,6,9,-2,2,2,2,loser,winner,1297,6,0,1,0.93449182,0.304915884
06/09/2006,6,Iraq,Iraq,Palestine,Palestine,2,2,AFC Asian Cup qualification,Al Ain,United Arab Emirates,2006,6,9,0,0,0,4,draw,draw,1298,6,0,0,0.62845222,0.40773011
20/05/1992,20,UAE,UAE,Syria,Syria,0,0,Friendly,Sharjah,United Arab Emirates,1992,2,5,0,0,0,0,draw,draw,690,5,0,0,0.62982932,0.096514944
01/10/2006,1,Libya,Libya,Sudan,Sudan,1,0,Friendly,Tripoli,Libya,2006,6,10,1,-1,1,1,winner,loser,1300,6,0,1,0.97017176,0.465606677
07/10/2006,7,Tunisia,Tunisia,Sudan,Sudan,1,0,African Cup of Nations qualification,Radès,Tunisia,2006,6,10,1,-1,1,1,winner,loser,1301,6,1,1,0.43315758,0.38252883
06/11/1992,6,Saudi Arabia,Saudi_Arabia,UAE,UAE,2,0,AFC Asian Cup,Hiroshima,Japan,1992,2,11,2,-2,2,2,winner,loser,698,5,0,0,0.77615376,0.258556324
28/11/1992,28,UAE,UAE,Kuwait,Kuwait,0,2,Gulf Cup,Doha,Qatar,1992,2,11,-2,2,2,2,loser,winner,704,5,0,0,0.37874434,0.460117862
08/11/2006,8,Oman,Oman,Bahrain,Bahrain,1,1,Friendly,Muscat,Oman,2006,6,11,0,0,0,2,draw,draw,1304,6,1,0,0.97224824,0.28622181
26/10/1993,26,UAE,UAE,Jordan,Jordan,2,1,Friendly,Al Ain,United Arab Emirates,1993,3,10,1,-1,1,3,winner,loser,739,5,0,1,0.39872204,0.440580193
15/11/2006,15,Bahrain,Bahrain,Kuwait,Kuwait,2,1,AFC Asian Cup qualification,Riffa,Bahrain,2006,6,11,1,-1,1,3,winner,loser,1306,6,0,0,0.18060509,0.349229164
15/11/2006,15,Jordan,Jordan,Oman,Oman,3,0,AFC Asian Cup qualification,Amman,Jordan,2006,6,11,3,-3,3,3,winner,loser,1307,6,1,1,0.33453071,0.581352605
15/11/2006,15,Tunisia,Tunisia,Libya,Libya,2,0,Friendly,Tunis,Tunisia,2006,6,11,2,-2,2,2,winner,loser,1308,6,1,0,0.74414072,0.772051414
30/11/2006,30,Somalia,Somalia,Sudan,Sudan,0,3,CECAFA Cup,Addis Abeba,Ethiopia,2006,6,11,-3,3,3,3,loser,winner,1309,6,1,1,0.05307202,0.842527298
14/12/2006,14,Yemen,Yemen,Comoros,Comoros,2,0,UAFA Cup qualification,Sana'a,Yemen,2006,6,12,2,-2,2,2,winner,loser,1310,6,1,1,0.02171167,0.971686088
17/12/2006,17,Djibouti,Djibouti,Comoros,Comoros,2,4,UAFA Cup qualification,Sana'a,Yemen,2006,6,12,-2,2,2,6,loser,winner,1311,6,0,1,0.59871,0.917744734
20/12/2006,20,Yemen,Yemen,Djibouti,Djibouti,4,1,UAFA Cup qualification,Sana'a,Yemen,2006,6,12,3,-3,3,5,winner,loser,1312,6,1,0,0.04171064,0.558523177
21/12/2006,21,Lebanon,Lebanon,Mauritania,Mauritania,0,0,UAFA Cup qualification,Beirut,Lebanon,2006,6,12,0,0,0,0,draw,draw,1313,6,1,1,0.33666848,0.765797068
21/12/2006,21,Sudan,Sudan,Somalia,Somalia,6,1,UAFA Cup qualification,Beirut,Lebanon,2006,6,12,5,-5,5,7,winner,loser,1314,6,1,1,0.52423426,0.740465128
24/12/2006,24,Lebanon,Lebanon,Somalia,Somalia,4,0,UAFA Cup qualification,Beirut,Lebanon,2006,6,12,4,-4,4,4,winner,loser,1315,6,1,1,0.81673744,0.748447987
24/12/2006,24,Sudan,Sudan,Mauritania,Mauritania,2,0,UAFA Cup qualification,Beirut,Lebanon,2006,6,12,2,-2,2,2,winner,loser,1316,6,1,1,0.88688324,0.039210856
27/12/2006,27,Lebanon,Lebanon,Sudan,Sudan,0,0,UAFA Cup qualification,Beirut,Lebanon,2006,6,12,0,0,0,0,draw,draw,1317,6,1,1,0.64515129,0.40031625
27/12/2006,27,Somalia,Somalia,Mauritania,Mauritania,2,8,UAFA Cup qualification,Beirut,Lebanon,2006,6,12,-6,6,6,10,loser,winner,1318,6,1,1,0.98043593,0.635749979
28/10/1993,28,UAE,UAE,Jordan,Jordan,0,2,Friendly,Al Ain,United Arab Emirates,1993,3,10,-2,2,2,2,loser,winner,740,5,0,1,0.36522374,0.980023563
13/01/2007,13,Qatar,Qatar,Oman,Oman,1,1,Friendly,Doha,Qatar,2007,7,1,0,0,0,2,draw,draw,1320,6,1,1,0.02364512,0.298544544
17/01/2007,17,Kuwait,Kuwait,Yemen,Yemen,1,1,Gulf Cup,Abu Dhabi,United Arab Emirates,2007,7,1,0,0,0,2,draw,draw,1321,6,0,1,0.22926802,0.922211787
04/02/1994,4,UAE,UAE,Morocco,Morocco,1,1,United Arab Emirates Friendship Tournament,Sharjah,United Arab Emirates,1994,4,2,0,0,0,2,draw,draw,743,5,0,0,0.40556076,0.764932518
18/01/2007,18,Qatar,Qatar,Iraq,Iraq,0,1,Gulf Cup,Abu Dhabi,United Arab Emirates,2007,7,1,-1,1,1,1,loser,winner,1323,6,1,0,0.22923659,0.161609387
06/02/1994,6,UAE,UAE,Egypt,Egypt,0,1,United Arab Emirates Friendship Tournament,Dubai,United Arab Emirates,1994,4,2,-1,1,1,1,loser,winner,744,5,0,1,0.20946009,0.731884396
20/01/2007,20,Kuwait,Kuwait,Oman,Oman,1,2,Gulf Cup,Abu Dhabi,United Arab Emirates,2007,7,1,-1,1,1,3,loser,winner,1325,6,0,1,0.1093699,0.909416692
03/11/1994,3,UAE,UAE,Qatar,Qatar,2,0,Gulf Cup,Abu Dhabi,United Arab Emirates,1994,4,11,2,-2,2,2,winner,loser,752,5,0,1,0.15622644,0.669378303
21/01/2007,21,Bahrain,Bahrain,Iraq,Iraq,1,1,Gulf Cup,Abu Dhabi,United Arab Emirates,2007,7,1,0,0,0,2,draw,draw,1327,6,0,0,0.58685487,0.95359077
01/12/1992,1,Saudi Arabia,Saudi_Arabia,UAE,UAE,0,1,Gulf Cup,Doha,Qatar,1992,2,12,-1,1,1,1,loser,winner,706,5,0,0,0.86000324,0.773470069
23/01/2007,23,Oman,Oman,Yemen,Yemen,2,1,Gulf Cup,Abu Dhabi,United Arab Emirates,2007,7,1,1,-1,1,3,winner,loser,1329,6,1,1,0.21172082,0.814064844
09/11/1994,9,UAE,UAE,Kuwait,Kuwait,2,0,Gulf Cup,Abu Dhabi,United Arab Emirates,1994,4,11,2,-2,2,2,winner,loser,759,5,0,0,0.36191957,0.041300355
24/01/2007,24,Qatar,Qatar,Bahrain,Bahrain,1,2,Gulf Cup,Abu Dhabi,United Arab Emirates,2007,7,1,-1,1,1,3,loser,winner,1331,6,1,0,0.26232966,0.14955668
12/11/1994,12,UAE,UAE,Bahrain,Bahrain,0,0,Gulf Cup,Abu Dhabi,United Arab Emirates,1994,4,11,0,0,0,0,draw,draw,762,5,0,0,0.51725362,0.685009833
27/01/2007,27,Oman,Oman,Bahrain,Bahrain,1,0,Gulf Cup,Abu Dhabi,United Arab Emirates,2007,7,1,1,-1,1,1,winner,loser,1333,6,1,0,0.46843127,0.981772323
16/11/1994,16,UAE,UAE,Oman,Oman,2,0,Gulf Cup,Abu Dhabi,United Arab Emirates,1994,4,11,2,-2,2,2,winner,loser,766,5,0,1,0.61083786,0.012640921
22/03/1996,22,UAE,UAE,Egypt,Egypt,0,0,United Arab Emirates Friendship Tournament,Dubai,United Arab Emirates,1996,6,3,0,0,0,0,draw,draw,791,5,0,1,0.70203255,0.557985116
07/02/2007,7,Algeria,Algeria,Libya,Libya,2,1,Friendly,Algiers,Algeria,2007,7,2,1,-1,1,3,winner,loser,1336,6,1,0,0.87111345,0.08166045
07/02/2007,7,Morocco,Morocco,Tunisia,Tunisia,1,1,Friendly,Casablanca,Morocco,2007,7,2,0,0,0,2,draw,draw,1337,6,0,1,0.38508907,0.856199406
20/03/2007,20,Libya,Libya,Mauritania,Mauritania,0,0,Friendly,Tripoli,Libya,2007,7,3,0,0,0,0,draw,draw,1338,6,0,1,0.5554431,0.994522084
25/03/2007,25,Egypt,Egypt,Mauritania,Mauritania,3,0,African Cup of Nations qualification,Cairo,Egypt,2007,7,3,3,-3,3,3,winner,loser,1339,6,1,1,0.49818386,0.496749607
03/06/2007,3,Mauritania,Mauritania,Egypt,Egypt,1,1,African Cup of Nations qualification,Nouakchott,Mauritania,2007,7,6,0,0,0,2,draw,draw,1340,6,1,1,0.03700761,0.393122865
08/06/2007,8,Jordan,Jordan,Iraq,Iraq,1,1,Friendly,Amman,Jordan,2007,7,6,0,0,0,2,draw,draw,1341,6,1,0,0.42848253,0.203320326
12/06/2007,12,Jordan,Jordan,Iraq,Iraq,0,0,Friendly,Amman,Jordan,2007,7,6,0,0,0,0,draw,draw,1342,6,1,0,0.80125094,0.787372217
12/06/2007,12,Kuwait,Kuwait,Egypt,Egypt,1,1,Friendly,Kuwait City,Kuwait,2007,7,6,0,0,0,2,draw,draw,1343,6,0,1,0.73990124,0.811873249
16/06/2007,16,Lebanon,Lebanon,Syria,Syria,0,1,WAFF Championship,Amman,Jordan,2007,7,6,-1,1,1,1,loser,winner,1344,6,1,0,0.70059278,0.484046916
18/06/2007,18,Jordan,Jordan,Syria,Syria,0,1,WAFF Championship,Amman,Jordan,2007,7,6,-1,1,1,1,loser,winner,1345,6,1,0,0.40700176,0.938514743
18/06/2007,18,Palestine,Palestine,Iraq,Iraq,0,1,WAFF Championship,Amman,Jordan,2007,7,6,-1,1,1,1,loser,winner,1346,6,0,0,0.20657139,0.826228408
20/06/2007,20,Jordan,Jordan,Lebanon,Lebanon,3,0,WAFF Championship,Amman,Jordan,2007,7,6,3,-3,3,3,winner,loser,1347,6,1,1,0.4656769,0.434964572
22/06/2007,22,Syria,Syria,Iraq,Iraq,0,3,WAFF Championship,Amman,Jordan,2007,7,6,-3,3,3,3,loser,winner,1348,6,0,0,0.68920151,0.201108298
26/03/1996,26,UAE,UAE,Morocco,Morocco,1,0,United Arab Emirates Friendship Tournament,Dubai,United Arab Emirates,1996,6,3,1,-1,1,1,winner,loser,792,5,0,0,0.91976375,0.052094295
16/10/1996,16,UAE,UAE,Qatar,Qatar,0,1,Gulf Cup,Muscat,Oman,1996,6,10,-1,1,1,1,loser,winner,809,5,0,1,0.50901081,0.629606477
05/03/1988,5,Kuwait,Kuwait,UAE,UAE,0,1,Gulf Cup,Riyadh,Saudi Arabia,1988,8,3,-1,1,1,1,loser,winner,563,4,0,0,0.64400565,0.099080557
16/07/2007,16,Oman,Oman,Iraq,Iraq,0,0,AFC Asian Cup,Bangkok,Thailand,2007,7,7,0,0,0,0,draw,draw,1352,6,1,0,0.44129248,0.856183123
08/03/1988,8,Qatar,Qatar,UAE,UAE,2,1,Gulf Cup,Riyadh,Saudi Arabia,1988,8,3,1,-1,1,3,winner,loser,567,4,1,0,0.76419092,0.244434759
18/10/1996,18,UAE,UAE,Bahrain,Bahrain,1,1,Gulf Cup,Muscat,Oman,1996,6,10,0,0,0,2,draw,draw,811,5,0,0,0.28020094,0.031633168
08/11/1998,8,Saudi Arabia,Saudi_Arabia,UAE,UAE,1,0,Gulf Cup,Manama,Bahrain,1998,8,11,1,-1,1,1,winner,loser,913,5,0,0,0.2799976,0.544202305
22/08/2007,22,Sudan,Sudan,Libya,Libya,1,0,Friendly,Khartoum,Sudan,2007,7,8,1,-1,1,1,winner,loser,1356,6,1,0,0.4732226,0.024867209
07/09/2007,7,Bahrain,Bahrain,Jordan,Jordan,1,3,Friendly,Muharraq,Bahrain,2007,7,9,-2,2,2,4,loser,winner,1357,6,0,1,0.06885766,0.786480665
09/09/2007,9,Sudan,Sudan,Tunisia,Tunisia,3,2,African Cup of Nations qualification,Khartoum,Sudan,2007,7,9,1,-1,1,5,winner,loser,1358,6,1,1,0.11120963,0.551856271
17/09/2007,17,Qatar,Qatar,Oman,Oman,1,1,Friendly,Doha,Qatar,2007,7,9,0,0,0,2,draw,draw,1359,6,1,1,0.84969824,0.537261551
05/12/1988,5,Qatar,Qatar,UAE,UAE,2,1,AFC Asian Cup,Doha,Qatar,1988,8,12,1,-1,1,3,winner,loser,616,4,1,0,0.61216229,0.858618256
16/10/2007,16,Bahrain,Bahrain,Libya,Libya,2,0,Friendly,Muharraq,Bahrain,2007,7,10,2,-2,2,2,winner,loser,1361,6,0,0,0.78791976,0.244114731
16/10/2007,16,Qatar,Qatar,Iraq,Iraq,3,2,Friendly,Doha,Qatar,2007,7,10,1,-1,1,5,winner,loser,1362,6,1,0,0.1898143,0.238874186
26/11/1996,26,UAE,UAE,Syria,Syria,1,1,Friendly,Abu Dhabi,United Arab Emirates,1996,6,11,0,0,0,2,draw,draw,824,5,0,0,0.98778395,0.792826095
16/11/2007,16,Djibouti,Djibouti,Somalia,Somalia,1,0,FIFA World Cup qualification,Djibouti,Djibouti,2007,7,11,1,-1,1,1,winner,loser,1364,6,0,1,0.34441225,0.008571207
11/12/2007,11,Oman,Oman,Jordan,Jordan,0,3,Friendly,Muscat,Oman,2007,7,12,-3,3,3,3,loser,winner,1365,6,1,1,0.18810962,0.954157211
02/01/2008,2,Kuwait,Kuwait,Lebanon,Lebanon,3,2,Friendly,Salmiya,Kuwait,2008,8,1,1,-1,1,5,winner,loser,1366,6,0,1,0.64090676,0.616864912
13/01/2008,13,Syria,Syria,Qatar,Qatar,0,0,Friendly,Damascus,Syria,2008,8,1,0,0,0,0,draw,draw,1367,6,0,1,0.75458179,0.541412911
16/01/2008,16,Bahrain,Bahrain,Kuwait,Kuwait,1,0,Friendly,Manama,Bahrain,2008,8,1,1,-1,1,1,winner,loser,1368,6,0,0,0.99594001,0.50101856
23/01/2008,23,Bahrain,Bahrain,Syria,Syria,1,2,Friendly,Manama,Bahrain,2008,8,1,-1,1,1,3,loser,winner,1369,6,0,0,0.7553449,0.267779684
24/01/2008,24,Iraq,Iraq,Jordan,Jordan,1,1,Friendly,Dubai,United Arab Emirates,2008,8,1,0,0,0,2,draw,draw,1370,6,0,1,0.51574525,0.453955011
26/01/2008,26,Bahrain,Bahrain,Yemen,Yemen,2,1,Friendly,Manama,Bahrain,2008,8,1,1,-1,1,3,winner,loser,1371,6,0,1,0.21098344,0.395306203
26/01/2008,26,Egypt,Egypt,Sudan,Sudan,3,0,African Cup of Nations,Kumasi,Ghana,2008,8,1,3,-3,3,3,winner,loser,1372,6,1,1,0.46210627,0.612433482
28/01/2008,28,Jordan,Jordan,Lebanon,Lebanon,4,1,Friendly,Amman,Jordan,2008,8,1,3,-3,3,5,winner,loser,1373,6,1,1,0.66482675,0.903300727
30/01/2008,30,Oman,Oman,Kuwait,Kuwait,1,1,Friendly,Muscat,Oman,2008,8,1,0,0,0,2,draw,draw,1374,6,1,0,0.31112803,0.796863391
28/11/1996,28,UAE,UAE,Syria,Syria,1,0,Friendly,Abu Dhabi,United Arab Emirates,1996,6,11,1,-1,1,1,winner,loser,825,5,0,0,0.82473697,0.05002998
06/02/2008,6,Oman,Oman,Bahrain,Bahrain,0,1,FIFA World Cup qualification,Muscat,Oman,2008,8,2,-1,1,1,1,loser,winner,1376,6,1,0,0.56789162,0.867678463
07/12/1996,7,UAE,UAE,Kuwait,Kuwait,3,2,AFC Asian Cup,Abu Dhabi,United Arab Emirates,1996,6,12,1,-1,1,5,winner,loser,826,5,0,0,0.0317848,0.830544543
04/03/2008,4,Qatar,Qatar,Bahrain,Bahrain,1,2,Friendly,Doha,Qatar,2008,8,3,-1,1,1,3,loser,winner,1378,6,1,0,0.80994467,0.237991179
16/03/2008,16,Qatar,Qatar,Jordan,Jordan,2,1,Friendly,Doha,Qatar,2008,8,3,1,-1,1,3,winner,loser,1379,6,1,1,0.48423986,0.279694683
13/01/1989,13,Kuwait,Kuwait,UAE,UAE,3,2,FIFA World Cup qualification,Kuwait City,Kuwait,1989,9,1,1,-1,1,5,winner,loser,625,4,0,0,0.84681633,0.446323232
21/03/2008,21,Kuwait,Kuwait,Iraq,Iraq,0,0,Friendly,Kuwait City,Kuwait,2008,8,3,0,0,0,0,draw,draw,1381,6,0,0,0.18619515,0.688850427
26/03/2008,26,Qatar,Qatar,Iraq,Iraq,2,0,FIFA World Cup qualification,Doha,Qatar,2008,8,3,2,-2,2,2,winner,loser,1382,6,1,0,0.7466783,0.977274649
28/09/2000,28,Saudi Arabia,Saudi_Arabia,UAE,UAE,6,1,Friendly,Abha,Saudi Arabia,2000,0,9,5,-5,5,7,winner,loser,972,6,0,0,0.87340658,0.895095079
03/05/2008,3,Oman,Oman,Yemen,Yemen,0,0,Friendly,Muscat,Oman,2008,8,5,0,0,0,0,draw,draw,1384,6,1,1,0.96257034,0.220306252
10/05/2008,10,Syria,Syria,Oman,Oman,2,1,Friendly,Damascus,Syria,2008,8,5,1,-1,1,3,winner,loser,1385,6,0,1,0.57732861,0.171144168
17/05/2008,17,Syria,Syria,Iraq,Iraq,2,1,Friendly,Damascus,Syria,2008,8,5,1,-1,1,3,winner,loser,1386,6,0,0,0.2559124,0.731748075
22/05/2008,22,Yemen,Yemen,Sudan,Sudan,1,1,Friendly,Sana'a,Yemen,2008,8,5,0,0,0,2,draw,draw,1387,6,1,1,0.24444122,0.885572058
23/05/2008,23,Qatar,Qatar,Kuwait,Kuwait,1,1,Friendly,Doha,Qatar,2008,8,5,0,0,0,2,draw,draw,1388,6,1,0,0.25766108,0.185555006
15/12/1996,15,UAE,UAE,Iraq,Iraq,1,0,AFC Asian Cup,Abu Dhabi,United Arab Emirates,1996,6,12,1,-1,1,1,winner,loser,828,5,0,0,0.82517686,0.369655952
27/05/2008,27,Qatar,Qatar,Lebanon,Lebanon,2,1,Friendly,Doha,Qatar,2008,8,5,1,-1,1,3,winner,loser,1390,6,1,1,0.8558889,0.135096369
19/12/1996,19,UAE,UAE,Kuwait,Kuwait,1,0,AFC Asian Cup,Abu Dhabi,United Arab Emirates,1996,6,12,1,-1,1,1,winner,loser,829,5,0,0,0.5066544,0.429477887
22/02/1990,22,Oman,Oman,UAE,UAE,1,1,Gulf Cup,Kuwait City,Kuwait,1990,0,2,0,0,0,2,draw,draw,665,5,1,0,0.29731419,0.441851701
02/06/2008,2,Syria,Syria,Kuwait,Kuwait,1,0,FIFA World Cup qualification,Damascus,Syria,2008,8,6,1,-1,1,1,winner,loser,1393,6,0,0,0.68784392,0.363001073
07/06/2008,7,Mauritania,Mauritania,Morocco,Morocco,1,4,FIFA World Cup qualification,Nouakchott,Mauritania,2008,8,6,-3,3,3,5,loser,winner,1394,6,1,0,0.60352615,0.85888962
19/03/1997,19,UAE,UAE,Lebanon,Lebanon,2,1,Friendly,Abu Dhabi,United Arab Emirates,1997,7,3,1,-1,1,3,winner,loser,842,5,0,1,0.81640389,0.722955514
08/06/2008,8,Kuwait,Kuwait,Syria,Syria,4,2,FIFA World Cup qualification,Kuwait City,Kuwait,2008,8,6,2,-2,2,6,winner,loser,1396,6,0,0,0.20710948,0.893868974
14/06/2008,14,Bahrain,Bahrain,Oman,Oman,1,1,FIFA World Cup qualification,Riffa,Bahrain,2008,8,6,0,0,0,2,draw,draw,1397,6,0,1,0.87212535,0.45029234
27/02/1990,27,Qatar,Qatar,UAE,UAE,0,0,Gulf Cup,Kuwait City,Kuwait,1990,0,2,0,0,0,0,draw,draw,668,5,1,0,0.91749857,0.22906022
22/06/2008,22,Iraq,Iraq,Qatar,Qatar,0,1,FIFA World Cup qualification,Dubai,United Arab Emirates,2008,8,6,-1,1,1,1,loser,winner,1399,6,0,1,0.78607858,0.4760602
22/04/1997,22,UAE,UAE,Bahrain,Bahrain,3,0,FIFA World Cup qualification,Sharjah,United Arab Emirates,1997,7,4,3,-3,3,3,winner,loser,847,5,0,0,0.25412388,0.594173598
07/08/2008,7,Syria,Syria,Jordan,Jordan,0,0,WAFF Championship,Teheran,Iran,2008,8,8,0,0,0,0,draw,draw,1401,6,0,1,0.30332511,0.790827179
09/08/2008,9,Oman,Oman,Syria,Syria,1,2,WAFF Championship,Teheran,Iran,2008,8,8,-1,1,1,3,loser,winner,1402,6,1,0,0.8033169,0.515709827
09/08/2008,9,Palestine,Palestine,Qatar,Qatar,0,1,WAFF Championship,Teheran,Iran,2008,8,8,-1,1,1,1,loser,winner,1403,6,0,1,0.17190023,0.537325178
13/08/2008,13,Jordan,Jordan,Qatar,Qatar,3,0,WAFF Championship,Teheran,Iran,2008,8,8,3,-3,3,3,winner,loser,1404,6,1,1,0.08598808,0.461098026
05/03/1990,5,Bahrain,Bahrain,UAE,UAE,1,0,Gulf Cup,Kuwait City,Kuwait,1990,0,3,1,-1,1,1,winner,loser,671,5,0,0,0.03289251,0.159108378
20/08/2008,20,Sudan,Sudan,Egypt,Egypt,4,0,Friendly,Omdurman,Sudan,2008,8,8,4,-4,4,4,winner,loser,1406,6,1,1,0.52507683,0.019630691
26/04/1997,26,UAE,UAE,Jordan,Jordan,2,0,FIFA World Cup qualification,Sharjah,United Arab Emirates,1997,7,4,2,-2,2,2,winner,loser,848,5,0,1,0.77413593,0.712375599
16/09/1998,16,UAE,UAE,Libya,Libya,5,1,Friendly,Abu Dhabi,United Arab Emirates,1998,8,9,4,-4,4,6,winner,loser,884,5,0,0,0.71675252,0.618089773
06/09/2008,6,Oman,Oman,Morocco,Morocco,0,0,Friendly,Muscat,Oman,2008,8,9,0,0,0,0,draw,draw,1409,6,1,0,0.77156115,0.387365079
10/09/2008,10,Qatar,Qatar,Bahrain,Bahrain,1,1,FIFA World Cup qualification,Doha,Qatar,2008,8,9,0,0,0,2,draw,draw,1410,6,1,0,0.8368387,0.683931351
27/09/1998,27,UAE,UAE,Sudan,Sudan,4,1,UAFA Cup,Doha,Qatar,1998,8,9,3,-3,3,5,winner,loser,891,5,0,1,0.65271354,0.531300715
11/10/2008,11,Morocco,Morocco,Mauritania,Mauritania,4,1,FIFA World Cup qualification,Rabat,Morocco,2008,8,10,3,-3,3,5,winner,loser,1412,6,0,1,0.64834433,0.455623787
12/10/2008,12,Egypt,Egypt,Djibouti,Djibouti,4,0,FIFA World Cup qualification,Cairo,Egypt,2008,8,10,4,-4,4,4,winner,loser,1413,6,1,0,0.23410835,0.876628383
26/10/2008,26,Palestine,Palestine,Jordan,Jordan,1,1,Friendly,Ar Ram,Palestine,2008,8,10,0,0,0,2,draw,draw,1414,6,0,1,0.22330162,0.309273293
17/10/1998,17,UAE,UAE,Sudan,Sudan,2,1,United Arab Emirates Friendship Tournament,Abu Dhabi,United Arab Emirates,1998,8,10,1,-1,1,3,winner,loser,898,5,0,1,0.51147167,0.731049142
09/03/1990,9,Kuwait,Kuwait,UAE,UAE,6,1,Gulf Cup,Kuwait City,Kuwait,1990,0,3,5,-5,5,7,winner,loser,674,5,0,0,0.75401763,0.447927584
23/12/2008,23,Djibouti,Djibouti,Somalia,Somalia,2,3,Friendly,Djibouti,Djibouti,2008,8,12,-1,1,1,5,loser,winner,1417,6,0,1,0.41475622,0.487524075
19/10/1998,19,UAE,UAE,Syria,Syria,1,0,United Arab Emirates Friendship Tournament,Abu Dhabi,United Arab Emirates,1998,8,10,1,-1,1,1,winner,loser,900,5,0,0,0.69460415,0.865386668
21/10/1998,21,UAE,UAE,Lebanon,Lebanon,1,0,United Arab Emirates Friendship Tournament,Abu Dhabi,United Arab Emirates,1998,8,10,1,-1,1,1,winner,loser,902,5,0,1,0.08909785,0.40438464
29/12/2008,29,Bahrain,Bahrain,Syria,Syria,2,2,Friendly,Manama,Bahrain,2008,8,12,0,0,0,4,draw,draw,1420,6,0,0,0.83871801,0.66608209
03/11/1998,3,UAE,UAE,Oman,Oman,3,2,Gulf Cup,Manama,Bahrain,1998,8,11,1,-1,1,5,winner,loser,908,5,0,1,0.81536058,0.494487562
04/01/2009,4,Bahrain,Bahrain,Iraq,Iraq,3,1,Gulf Cup,Muscat,Oman,2009,9,1,2,-2,2,4,winner,loser,1422,6,0,0,0.96283003,0.563329609
04/01/2009,4,Djibouti,Djibouti,Sudan,Sudan,1,1,CECAFA Cup,Jinja,Uganda,2009,9,1,0,0,0,2,draw,draw,1423,6,0,1,0.33512356,0.564482625
04/01/2009,4,Oman,Oman,Kuwait,Kuwait,0,0,Gulf Cup,Muscat,Oman,2009,9,1,0,0,0,0,draw,draw,1424,6,1,0,0.6836921,0.02358029
12/11/1998,12,UAE,UAE,Kuwait,Kuwait,1,4,Gulf Cup,Manama,Bahrain,1998,8,11,-3,3,3,5,loser,winner,917,5,0,0,0.95521537,0.045067324
03/11/1999,3,UAE,UAE,Iraq,Iraq,2,2,United Arab Emirates Friendship Tournament,Abu Dhabi,United Arab Emirates,1999,9,11,0,0,0,4,draw,draw,929,5,0,0,0.85811777,0.047933038
07/01/2009,7,Bahrain,Bahrain,Kuwait,Kuwait,0,1,Gulf Cup,Muscat,Oman,2009,9,1,-1,1,1,1,loser,winner,1427,6,0,0,0.1181534,0.612245367
07/01/2009,7,Oman,Oman,Iraq,Iraq,4,0,Gulf Cup,Muscat,Oman,2009,9,1,4,-4,4,4,winner,loser,1428,6,1,0,0.30722393,0.969964176
07/09/2001,7,Saudi Arabia,Saudi_Arabia,UAE,UAE,0,2,Friendly,Dammam,Saudi Arabia,2001,1,9,-2,2,2,2,loser,winner,1025,6,0,0,0.1042508,0.6266715
07/10/2000,7,UAE,UAE,Kuwait,Kuwait,1,0,United Arab Emirates Friendship Tournament,Dubai,United Arab Emirates,2000,0,10,1,-1,1,1,winner,loser,975,6,0,0,0.0162935,0.104447106
10/01/2009,10,Iraq,Iraq,Kuwait,Kuwait,1,1,Gulf Cup,Muscat,Oman,2009,9,1,0,0,0,2,draw,draw,1431,6,0,0,0.06047447,0.263781327
10/01/2009,10,Oman,Oman,Bahrain,Bahrain,2,0,Gulf Cup,Muscat,Oman,2009,9,1,2,-2,2,2,winner,loser,1432,6,1,0,0.05123948,0.969688291
11/01/2009,11,Qatar,Qatar,Yemen,Yemen,2,1,Gulf Cup,Muscat,Oman,2009,9,1,1,-1,1,3,winner,loser,1433,6,1,1,0.68276957,0.140534007
14/02/2001,14,UAE,UAE,Morocco,Morocco,1,1,United Arab Emirates Friendship Tournament,Dubai,United Arab Emirates,2001,1,2,0,0,0,2,draw,draw,994,6,0,0,0.35691004,0.785124398
24/01/2002,24,Saudi Arabia,Saudi_Arabia,UAE,UAE,1,0,Gulf Cup,Riyadh,Saudi Arabia,2002,2,1,1,-1,1,1,winner,loser,1053,6,0,0,0.52907065,0.621424069
14/01/2009,14,Oman,Oman,Qatar,Qatar,1,0,Gulf Cup,Muscat,Oman,2009,9,1,1,-1,1,1,winner,loser,1436,6,1,1,0.83621262,0.150852101
24/11/1992,24,Algeria,Algeria,UAE,UAE,0,0,Friendly,Manama,Bahrain,1992,2,11,0,0,0,0,draw,draw,701,5,1,0,0.86128453,0.639018647
23/01/2009,23,Kuwait,Kuwait,Syria,Syria,2,3,Friendly,Kuwait City,Kuwait,2009,9,1,-1,1,1,5,loser,winner,1438,6,0,0,0.5905819,0.406476132
28/01/2009,28,Kuwait,Kuwait,Oman,Oman,0,1,AFC Asian Cup qualification,Kuwait City,Kuwait,2009,9,1,-1,1,1,1,loser,winner,1439,6,0,1,0.9940174,0.160357331
28/01/2009,28,Lebanon,Lebanon,Syria,Syria,0,2,AFC Asian Cup qualification,Sidon,Lebanon,2009,9,1,-2,2,2,2,loser,winner,1440,6,1,0,0.45649524,0.693323785
17/03/2009,17,Qatar,Qatar,Kuwait,Kuwait,1,0,Friendly,Doha,Qatar,2009,9,3,1,-1,1,1,winner,loser,1441,6,1,0,0.7774497,0.083057852
21/03/2009,21,Syria,Syria,Qatar,Qatar,1,2,Friendly,Aleppo,Syria,2009,9,3,-1,1,1,3,loser,winner,1442,6,0,1,0.33890606,0.708117501
18/05/2001,18,UAE,UAE,Yemen,Yemen,3,2,FIFA World Cup qualification,Al Ain,United Arab Emirates,2001,1,5,1,-1,1,5,winner,loser,1010,6,0,1,0.90992757,0.63030068
01/04/2009,1,Bahrain,Bahrain,Qatar,Qatar,1,0,FIFA World Cup qualification,Riffa,Bahrain,2009,9,4,1,-1,1,1,winner,loser,1444,6,0,1,0.77425487,0.001164808
02/08/2001,2,UAE,UAE,Iraq,Iraq,2,2,Friendly,Abu Dhabi,United Arab Emirates,2001,1,8,0,0,0,4,draw,draw,1016,6,0,0,0.42952006,0.334646934
04/12/1992,4,Bahrain,Bahrain,UAE,UAE,0,2,Gulf Cup,Doha,Qatar,1992,2,12,-2,2,2,2,loser,winner,709,5,0,0,0.00432905,0.019397213
28/05/2009,28,Tunisia,Tunisia,Sudan,Sudan,4,0,Friendly,Radès,Tunisia,2009,9,5,4,-4,4,4,winner,loser,1447,6,1,1,0.60082416,0.937028029
30/05/2009,30,Oman,Oman,Egypt,Egypt,0,1,Friendly,Muscat,Oman,2009,9,5,-1,1,1,1,loser,winner,1448,6,1,1,0.14004725,0.180564867
31/05/2009,31,Qatar,Qatar,Iraq,Iraq,1,0,Friendly,Doha,Qatar,2009,9,5,1,-1,1,1,winner,loser,1449,6,1,0,0.95206706,0.605892671
03/06/2009,3,Bahrain,Bahrain,Jordan,Jordan,4,0,Friendly,Riffa,Bahrain,2009,9,6,4,-4,4,4,winner,loser,1450,6,0,1,0.2751984,0.063927179
10/07/2009,10,Iraq,Iraq,Palestine,Palestine,3,0,Friendly,Arbil,Iraq,2009,9,7,3,-3,3,3,winner,loser,1451,6,0,0,0.08213456,0.252191181
13/07/2009,13,Iraq,Iraq,Palestine,Palestine,4,0,Friendly,Baghdad,Iraq,2009,9,7,4,-4,4,4,winner,loser,1452,6,0,0,0.75880841,0.552189357
06/12/1992,6,Qatar,Qatar,UAE,UAE,1,0,Gulf Cup,Doha,Qatar,1992,2,12,1,-1,1,1,winner,loser,712,5,1,0,0.83266027,0.765114348
27/08/2009,27,Syria,Syria,Lebanon,Lebanon,1,0,Nehru Cup,New Delhi,India,2009,9,8,1,-1,1,1,winner,loser,1454,6,0,1,0.5173693,0.82236603
09/12/1992,9,Oman,Oman,UAE,UAE,0,1,Gulf Cup,Doha,Qatar,1992,2,12,-1,1,1,1,loser,winner,714,5,1,0,0.67652036,0.970021111
09/09/2009,9,Qatar,Qatar,Oman,Oman,1,1,Friendly,Doha,Qatar,2009,9,9,0,0,0,2,draw,draw,1456,6,1,1,0.15402624,0.740244187
22/10/1996,22,Kuwait,Kuwait,UAE,UAE,1,2,Gulf Cup,Muscat,Oman,1996,6,10,-1,1,1,3,loser,winner,815,5,0,0,0.08576215,0.810462225
05/10/2009,5,Kuwait,Kuwait,Libya,Libya,1,1,Friendly,Cairo,Egypt,2009,9,10,0,0,0,2,draw,draw,1458,6,0,0,0.47792553,0.851293363
10/10/2009,10,Kuwait,Kuwait,Jordan,Jordan,2,1,Friendly,Cairo,Egypt,2009,9,10,1,-1,1,3,winner,loser,1459,6,0,1,0.68149105,0.583414652
31/08/2001,31,UAE,UAE,Qatar,Qatar,0,2,FIFA World Cup qualification,Abu Dhabi,United Arab Emirates,2001,1,8,-2,2,2,2,loser,winner,1024,6,0,1,0.03077967,0.170564633
24/10/1996,24,Oman,Oman,UAE,UAE,0,0,Gulf Cup,Muscat,Oman,1996,6,10,0,0,0,0,draw,draw,817,5,1,0,0.69558757,0.188420007
19/10/2001,19,UAE,UAE,Oman,Oman,2,2,FIFA World Cup qualification,Abu Dhabi,United Arab Emirates,2001,1,10,0,0,0,4,draw,draw,1035,6,0,1,0.5868356,0.092052373
26/10/2009,26,Kuwait,Kuwait,Syria,Syria,1,0,Friendly,Al-Jahra,Kuwait,2009,9,10,1,-1,1,1,winner,loser,1463,6,0,0,0.17952929,0.664414549
14/11/2009,14,Egypt,Egypt,Algeria,Algeria,2,0,FIFA World Cup qualification,Cairo,Egypt,2009,9,11,2,-2,2,2,winner,loser,1464,6,1,1,0.57326614,0.632077198
18/11/2009,18,Algeria,Algeria,Egypt,Egypt,1,0,FIFA World Cup qualification,Omdurman,Sudan,2009,9,11,1,-1,1,1,winner,loser,1465,6,1,1,0.20650308,0.886285275
18/11/2009,18,Bahrain,Bahrain,Yemen,Yemen,4,0,AFC Asian Cup qualification,Riffa,Bahrain,2009,9,11,4,-4,4,4,winner,loser,1466,6,0,1,0.56147672,0.737189601
17/01/2002,17,UAE,UAE,Oman,Oman,1,0,Gulf Cup,Riyadh,Saudi Arabia,2002,2,1,1,-1,1,1,winner,loser,1047,6,0,1,0.30900902,0.725067064
27/08/2006,27,Saudi Arabia,Saudi_Arabia,UAE,UAE,1,0,Friendly,Jeddah,Saudi Arabia,2006,6,8,1,-1,1,1,winner,loser,1294,6,0,0,0.31572745,0.640915559
20/01/2010,20,Yemen,Yemen,Bahrain,Bahrain,3,0,AFC Asian Cup qualification,Sana'a,Yemen,2010,0,1,3,-3,3,3,winner,loser,1469,7,1,0,0.50973263,0.234943186
28/01/2010,28,Algeria,Algeria,Egypt,Egypt,0,4,African Cup of Nations,Benguela,Angola,2010,0,1,-4,4,4,4,loser,winner,1470,7,1,1,0.21309097,0.407752014
19/02/2010,19,Kuwait,Kuwait,Syria,Syria,1,1,Friendly,Al Ain,United Arab Emirates,2010,0,2,0,0,0,2,draw,draw,1471,7,0,0,0.23645713,0.246817427
25/02/2010,25,Kuwait,Kuwait,Bahrain,Bahrain,4,1,Friendly,Al Ain,United Arab Emirates,2010,0,2,3,-3,3,5,winner,loser,1472,7,0,0,0.49275461,0.328668739
03/03/2010,3,Oman,Oman,Kuwait,Kuwait,0,0,AFC Asian Cup qualification,Muscat,Oman,2010,0,3,0,0,0,0,draw,draw,1473,7,1,0,0.38967344,0.598361313
03/03/2010,3,Syria,Syria,Lebanon,Lebanon,4,0,AFC Asian Cup qualification,Damascus,Syria,2010,0,3,4,-4,4,4,winner,loser,1474,7,0,1,0.3851583,0.952129305
18/05/2010,18,Yemen,Yemen,Oman,Oman,0,1,Friendly,Sana'a,Yemen,2010,0,5,-1,1,1,1,loser,winner,1475,7,1,1,0.8019374,0.306425779
04/06/2010,4,Sudan,Sudan,Palestine,Palestine,1,1,Friendly,Omdurman,Sudan,2010,0,6,0,0,0,2,draw,draw,1476,7,1,0,0.81578729,0.308007594
08/04/1997,8,Jordan,Jordan,UAE,UAE,0,0,FIFA World Cup qualification,Manama,Bahrain,1997,7,4,0,0,0,0,draw,draw,843,5,1,0,0.44745894,0.894714533
20/06/2010,20,Sudan,Sudan,Tunisia,Tunisia,2,6,Friendly,Omdurman,Sudan,2010,0,6,-4,4,4,8,loser,winner,1478,7,1,1,0.29364211,0.797876242
11/08/2010,11,Mauritania,Mauritania,Palestine,Palestine,0,0,Friendly,Nouakchott,Mauritania,2010,0,8,0,0,0,0,draw,draw,1479,7,1,0,0.12336773,0.136875974
03/09/2010,3,Kuwait,Kuwait,Syria,Syria,3,0,Friendly,Kuwait City,Kuwait,2010,0,9,3,-3,3,3,winner,loser,1480,7,0,0,0.11337752,0.942739255
03/09/2010,3,Qatar,Qatar,Bahrain,Bahrain,1,1,Friendly,Doha,Qatar,2010,0,9,0,0,0,2,draw,draw,1481,7,1,0,0.00569593,0.211026403
07/09/2010,7,Qatar,Qatar,Oman,Oman,1,1,Friendly,Doha,Qatar,2010,0,9,0,0,0,2,draw,draw,1482,7,1,1,0.95699426,0.502547836
20/01/2002,20,UAE,UAE,Qatar,Qatar,0,2,Gulf Cup,Riyadh,Saudi Arabia,2002,2,1,-2,2,2,2,loser,winner,1050,6,0,1,0.20996858,0.48103488
07/09/2010,7,Yemen,Yemen,Syria,Syria,2,1,Friendly,Sana'a,Yemen,2010,0,9,1,-1,1,3,winner,loser,1484,7,1,0,0.59139288,0.497225588
16/09/2010,16,Jordan,Jordan,Iraq,Iraq,4,1,Friendly,Amman,Jordan,2010,0,9,3,-3,3,5,winner,loser,1485,7,1,0,0.76210066,0.856897969
19/09/2010,19,Jordan,Jordan,Bahrain,Bahrain,2,0,Friendly,Zarqa,Jordan,2010,0,9,2,-2,2,2,winner,loser,1486,7,1,0,0.93061754,0.39413058
21/09/2010,21,Iraq,Iraq,Oman,Oman,3,2,Friendly,Amman,Jordan,2010,0,9,1,-1,1,5,winner,loser,1487,7,0,1,0.30312286,0.623566792
24/09/2010,24,Jordan,Jordan,Syria,Syria,1,1,WAFF Championship,Amman,Jordan,2010,0,9,0,0,0,2,draw,draw,1488,7,1,0,0.98409881,0.358046017
25/09/2010,25,Iraq,Iraq,Yemen,Yemen,2,1,WAFF Championship,Amman,Jordan,2010,0,9,1,-1,1,3,winner,loser,1489,7,0,1,0.78249797,0.993295683
26/09/2010,26,Bahrain,Bahrain,Oman,Oman,2,0,WAFF Championship,Amman,Jordan,2010,0,9,2,-2,2,2,winner,loser,1490,7,0,1,0.39100819,0.78739601
26/09/2010,26,Syria,Syria,Kuwait,Kuwait,1,2,WAFF Championship,Amman,Jordan,2010,0,9,-1,1,1,3,loser,winner,1491,7,0,0,0.85227088,0.386174384
27/09/2010,27,Yemen,Yemen,Palestine,Palestine,3,1,WAFF Championship,Amman,Jordan,2010,0,9,2,-2,2,4,winner,loser,1492,7,1,0,0.57586904,0.421564309
28/09/2010,28,Jordan,Jordan,Kuwait,Kuwait,2,2,WAFF Championship,Amman,Jordan,2010,0,9,0,0,0,4,draw,draw,1493,7,1,0,0.68407913,0.189138822
29/09/2010,29,Palestine,Palestine,Iraq,Iraq,0,3,WAFF Championship,Amman,Jordan,2010,0,9,-3,3,3,3,loser,winner,1494,7,0,0,0.96425033,0.902053345
01/10/2010,1,Kuwait,Kuwait,Yemen,Yemen,1,1,WAFF Championship,Amman,Jordan,2010,0,10,0,0,0,2,draw,draw,1495,7,0,1,0.56363035,0.170731974
08/10/2010,8,Kuwait,Kuwait,Bahrain,Bahrain,1,3,Friendly,Kuwait City,Kuwait,2010,0,10,-2,2,2,4,loser,winner,1496,7,0,0,0.20248565,0.588386588
12/10/2010,12,Qatar,Qatar,Iraq,Iraq,1,2,Friendly,Doha,Qatar,2010,0,10,-1,1,1,3,loser,winner,1497,7,1,0,0.90654394,0.290325069
14/11/2010,14,Bahrain,Bahrain,Syria,Syria,0,2,Friendly,Riffa,Bahrain,2010,0,11,-2,2,2,2,loser,winner,1498,7,0,0,0.76265125,0.778658507
17/11/2010,17,Iraq,Iraq,Kuwait,Kuwait,1,1,Friendly,Abu Dhabi,United Arab Emirates,2010,0,11,0,0,0,2,draw,draw,1499,7,0,0,0.15552696,0.397569889
22/11/2010,22,Kuwait,Kuwait,Qatar,Qatar,1,0,Gulf Cup,Aden,Yemen,2010,0,11,1,-1,1,1,winner,loser,1500,7,0,1,0.21872904,0.470951584
11/04/1997,11,Bahrain,Bahrain,UAE,UAE,1,2,FIFA World Cup qualification,Manama,Bahrain,1997,7,4,-1,1,1,3,loser,winner,844,5,0,0,0.94378745,0.324129537
29/09/1998,29,Qatar,Qatar,UAE,UAE,2,1,UAFA Cup,Doha,Qatar,1998,8,9,1,-1,1,3,winner,loser,892,5,1,0,0.90091307,0.3388271
23/11/2010,23,Oman,Oman,Bahrain,Bahrain,1,1,Gulf Cup,Aden,Yemen,2010,0,11,0,0,0,2,draw,draw,1503,7,1,0,0.37480459,0.972685657
27/01/2002,27,UAE,UAE,Bahrain,Bahrain,1,2,Gulf Cup,Riyadh,Saudi Arabia,2002,2,1,-1,1,1,3,loser,winner,1056,6,0,0,0.52232046,0.024388004
25/11/2010,25,Yemen,Yemen,Qatar,Qatar,1,2,Gulf Cup,Zinjibar,Yemen,2010,0,11,-1,1,1,3,loser,winner,1505,7,1,1,0.12474898,0.512082567
26/11/2010,26,Bahrain,Bahrain,Iraq,Iraq,2,3,Gulf Cup,Aden,Yemen,2010,0,11,-1,1,1,5,loser,winner,1506,7,0,0,0.87147133,0.715564124
16/12/2002,16,UAE,UAE,Egypt,Egypt,1,2,Friendly,Abu Dhabi,United Arab Emirates,2002,2,12,-1,1,1,3,loser,winner,1081,6,0,1,0.92143414,0.270963702
01/04/2009,1,Saudi Arabia,Saudi_Arabia,UAE,UAE,3,2,FIFA World Cup qualification,Riyadh,Saudi Arabia,2009,9,4,1,-1,1,5,winner,loser,1445,6,0,0,0.65547417,0.74130791
28/11/2010,28,Yemen,Yemen,Kuwait,Kuwait,0,3,Gulf Cup,Zinjibar,Yemen,2010,0,11,-3,3,3,3,loser,winner,1509,7,1,0,0.75760149,0.775741379
29/11/2010,29,Oman,Oman,Iraq,Iraq,0,0,Gulf Cup,Zinjibar,Yemen,2010,0,11,0,0,0,0,draw,draw,1510,7,1,0,0.38441769,0.76623353
14/11/2003,14,UAE,UAE,Syria,Syria,3,1,AFC Asian Cup qualification,Sharjah,United Arab Emirates,2003,3,11,2,-2,2,4,winner,loser,1125,6,0,0,0.23923859,0.667475354
02/12/2010,2,Kuwait,Kuwait,Iraq,Iraq,2,2,Gulf Cup,Aden,Yemen,2010,0,12,0,0,0,4,draw,draw,1512,7,0,0,0.3361861,0.792515031
01/10/1998,1,Kuwait,Kuwait,UAE,UAE,4,1,UAFA Cup,Doha,Qatar,1998,8,10,3,-3,3,5,winner,loser,894,5,0,0,0.57564073,0.02918312
30/10/1998,30,Bahrain,Bahrain,UAE,UAE,0,1,Gulf Cup,Manama,Bahrain,1998,8,10,-1,1,1,1,loser,winner,903,5,0,0,0.73804333,0.753784956
16/12/2010,16,Qatar,Qatar,Egypt,Egypt,2,1,Friendly,Doha,Qatar,2010,0,12,1,-1,1,3,winner,loser,1515,7,1,1,0.57668022,0.661870657
18/12/2010,18,Iraq,Iraq,Syria,Syria,0,1,Friendly,Sulaymaniyah,Iraq,2010,0,12,-1,1,1,1,loser,winner,1516,7,0,0,0.44420555,0.658289986
22/12/2010,22,Syria,Syria,Iraq,Iraq,0,1,Friendly,Damascus,Syria,2010,0,12,-1,1,1,1,loser,winner,1517,7,0,0,0.99301654,0.012504016
28/12/2010,28,Bahrain,Bahrain,Jordan,Jordan,2,1,Friendly,Dubai,United Arab Emirates,2010,0,12,1,-1,1,3,winner,loser,1518,7,0,1,0.78295893,0.157448024
03/01/2004,3,UAE,UAE,Qatar,Qatar,0,0,Gulf Cup,Kuwait City,Kuwait,2004,4,1,0,0,0,0,draw,draw,1143,6,0,1,0.8929866,0.623342409
07/01/2004,7,UAE,UAE,Bahrain,Bahrain,1,3,Gulf Cup,Kuwait City,Kuwait,2004,4,1,-2,2,2,4,loser,winner,1147,6,0,0,0.64966142,0.921318403
31/05/2004,31,UAE,UAE,Bahrain,Bahrain,2,3,Friendly,Dubai,United Arab Emirates,2004,4,5,-1,1,1,5,loser,winner,1171,6,0,0,0.2660247,0.51661387
05/11/1998,5,Qatar,Qatar,UAE,UAE,0,0,Gulf Cup,Manama,Bahrain,1998,8,11,0,0,0,0,draw,draw,910,5,1,0,0.00260602,0.713135455
09/06/2004,9,UAE,UAE,Yemen,Yemen,3,0,FIFA World Cup qualification,Al Ain,United Arab Emirates,2004,4,6,3,-3,3,3,winner,loser,1175,6,0,1,0.90359456,0.287479074
16/01/2011,16,Qatar,Qatar,Kuwait,Kuwait,3,0,AFC Asian Cup,Doha,Qatar,2011,1,1,3,-3,3,3,winner,loser,1524,7,1,0,0.29733563,0.739227067
17/01/2011,17,Jordan,Jordan,Syria,Syria,2,1,AFC Asian Cup,Doha,Qatar,2011,1,1,1,-1,1,3,winner,loser,1525,7,1,0,0.90918837,0.928614168
14/02/2011,14,Bahrain,Bahrain,Kuwait,Kuwait,0,0,Friendly,Riffa,Bahrain,2011,1,2,0,0,0,0,draw,draw,1526,7,0,0,0.26183811,0.625366253
26/03/2011,26,Jordan,Jordan,Kuwait,Kuwait,1,1,Friendly,Sharjah,United Arab Emirates,2011,1,3,0,0,0,2,draw,draw,1527,7,1,0,0.88163778,0.408086155
27/03/2011,27,Algeria,Algeria,Morocco,Morocco,1,0,African Cup of Nations qualification,Annaba,Algeria,2011,1,3,1,-1,1,1,winner,loser,1528,7,1,0,0.68204085,0.461891613
29/03/2011,29,Kuwait,Kuwait,Iraq,Iraq,1,0,Friendly,Sharjah,United Arab Emirates,2011,1,3,1,-1,1,1,winner,loser,1529,7,0,0,0.50462063,0.379301891
29/03/2011,29,Oman,Oman,Tunisia,Tunisia,2,1,Friendly,Muscat,Oman,2011,1,3,1,-1,1,3,winner,loser,1530,7,1,1,0.45406998,0.861314966
04/06/2011,4,Morocco,Morocco,Algeria,Algeria,4,0,African Cup of Nations qualification,Marrakech,Morocco,2011,1,6,4,-4,4,4,winner,loser,1531,7,0,1,0.8372087,0.410729514
05/06/2011,5,Comoros,Comoros,Libya,Libya,1,1,African Cup of Nations qualification,Mitsamiouli,Comoros,2011,1,6,0,0,0,2,draw,draw,1532,7,1,0,0.17233654,0.663097011
29/06/2011,29,Iraq,Iraq,Syria,Syria,1,2,Friendly,Arbil,Iraq,2011,1,6,-1,1,1,3,loser,winner,1533,7,0,0,0.91640424,0.454382052
02/07/2011,2,Lebanon,Lebanon,Kuwait,Kuwait,0,6,Friendly,Beirut,Lebanon,2011,1,7,-6,6,6,6,loser,winner,1534,7,1,0,0.92939476,0.987954357
05/07/2011,5,Jordan,Jordan,Syria,Syria,1,3,Friendly,Istanbul,Turkey,2011,1,7,-2,2,2,4,loser,winner,1535,7,1,0,0.99037411,0.364773601
06/07/2011,6,Kuwait,Kuwait,Oman,Oman,1,1,Friendly,Beirut,Lebanon,2011,1,7,0,0,0,2,draw,draw,1536,7,0,1,0.28664902,0.366716602
08/07/2011,8,Jordan,Jordan,Yemen,Yemen,4,0,Friendly,Istanbul,Turkey,2011,1,7,4,-4,4,4,winner,loser,1537,7,1,1,0.75669828,0.898236929
09/07/2011,9,Lebanon,Lebanon,Oman,Oman,0,1,Friendly,Beirut,Lebanon,2011,1,7,-1,1,1,1,loser,winner,1538,7,1,1,0.65669894,0.345780609
13/07/2011,13,Iraq,Iraq,Kuwait,Kuwait,0,2,Friendly,Amman,Jordan,2011,1,7,-2,2,2,2,loser,winner,1539,7,0,0,0.72675926,0.185890719
16/10/1999,16,Tunisia,Tunisia,UAE,UAE,1,0,Friendly,Tunis,Tunisia,1999,9,10,1,-1,1,1,winner,loser,928,5,1,0,0.46689959,0.114926028
15/07/2011,15,Oman,Oman,Syria,Syria,1,1,Friendly,Muscat,Oman,2011,1,7,0,0,0,2,draw,draw,1541,7,1,0,0.13487518,0.109177264
16/07/2011,16,Jordan,Jordan,Iraq,Iraq,1,1,Friendly,Amman,Jordan,2011,1,7,0,0,0,2,draw,draw,1542,7,1,0,0.39452124,0.828326959
21/02/2000,21,Oman,Oman,UAE,UAE,0,1,Friendly,Muscat,Oman,2000,0,2,-1,1,1,1,loser,winner,934,6,1,0,0.84871117,0.269770447
11/11/2004,11,UAE,UAE,Jordan,Jordan,4,0,Friendly,Abu Dhabi,United Arab Emirates,2004,4,11,4,-4,4,4,winner,loser,1205,6,0,1,0.54548214,0.237365072
23/07/2011,23,Iraq,Iraq,Yemen,Yemen,2,0,FIFA World Cup qualification,Arbil,Iraq,2011,1,7,2,-2,2,2,winner,loser,1545,7,0,1,0.78576289,0.664263247
28/07/2011,28,Yemen,Yemen,Iraq,Iraq,0,0,FIFA World Cup qualification,al-Ain,United Arab Emirates,2011,1,7,0,0,0,0,draw,draw,1546,7,1,0,0.32361404,0.078410966
10/08/2011,10,Oman,Oman,Bahrain,Bahrain,1,1,Friendly,Dubai,United Arab Emirates,2011,1,8,0,0,0,2,draw,draw,1547,7,1,0,0.08979164,0.664923688
17/08/2011,17,Lebanon,Lebanon,Syria,Syria,2,3,Friendly,Sidon,Lebanon,2011,1,8,-1,1,1,5,loser,winner,1548,7,1,0,0.75920001,0.759881657
19/08/2011,19,Qatar,Qatar,Iraq,Iraq,0,1,Friendly,Doha,Qatar,2011,1,8,-1,1,1,1,loser,winner,1549,7,1,0,0.20301934,0.58303248
22/08/2011,22,Jordan,Jordan,Tunisia,Tunisia,3,3,Friendly,Amman,Jordan,2011,1,8,0,0,0,6,draw,draw,1550,7,1,1,0.58312773,0.445231718
27/11/2004,27,UAE,UAE,Kuwait,Kuwait,0,1,Friendly,Abu Dhabi,United Arab Emirates,2004,4,11,-1,1,1,1,loser,winner,1208,6,0,0,0.36879989,0.84235063
26/08/2011,26,Bahrain,Bahrain,Sudan,Sudan,1,0,Friendly,Riffa,Bahrain,2011,1,8,1,-1,1,1,winner,loser,1552,7,0,1,0.35251534,0.722931876
27/08/2011,27,Oman,Oman,Kuwait,Kuwait,1,0,Friendly,Muscat,Oman,2011,1,8,1,-1,1,1,winner,loser,1553,7,1,0,0.65307943,0.5508471
02/09/2011,2,Bahrain,Bahrain,Qatar,Qatar,0,0,FIFA World Cup qualification,Riffa,Bahrain,2011,1,9,0,0,0,0,draw,draw,1554,7,0,1,0.59194484,0.350052242
02/09/2011,2,Iraq,Iraq,Jordan,Jordan,0,2,FIFA World Cup qualification,Arbil,Iraq,2011,1,9,-2,2,2,2,loser,winner,1555,7,0,1,0.93297515,0.811064412
07/09/2000,7,Lebanon,Lebanon,UAE,UAE,0,1,Friendly,Beirut,Lebanon,2000,0,9,-1,1,1,1,loser,winner,966,6,1,0,0.39897655,0.667894908
03/12/2004,3,UAE,UAE,Kuwait,Kuwait,1,1,Friendly,Dubai,United Arab Emirates,2004,4,12,0,0,0,2,draw,draw,1211,6,0,0,0.37175638,0.409247782
10/09/2000,10,Lebanon,Lebanon,UAE,UAE,2,2,Friendly,Beirut,Lebanon,2000,0,9,0,0,0,4,draw,draw,967,6,1,0,0.73758126,0.120350416
11/10/2011,11,Lebanon,Lebanon,Kuwait,Kuwait,2,2,FIFA World Cup qualification,Beirut,Lebanon,2011,1,10,0,0,0,4,draw,draw,1559,7,1,0,0.51610637,0.076993985
04/11/2011,4,Kuwait,Kuwait,Bahrain,Bahrain,0,1,Friendly,Kuwait City,Kuwait,2011,1,11,-1,1,1,1,loser,winner,1560,7,0,0,0.77887303,0.017986915
04/11/2011,4,Qatar,Qatar,Oman,Oman,0,0,Friendly,Doha,Qatar,2011,1,11,0,0,0,0,draw,draw,1561,7,1,1,0.87993128,0.108231482
06/11/2011,6,Iraq,Iraq,Lebanon,Lebanon,1,0,Friendly,Doha,Qatar,2011,1,11,1,-1,1,1,winner,loser,1562,7,0,1,0.7606329,0.930494455
11/11/2011,11,Kuwait,Kuwait,Lebanon,Lebanon,0,1,FIFA World Cup qualification,Kuwait City,Kuwait,2011,1,11,-1,1,1,1,loser,winner,1563,7,0,1,0.82345709,0.051735166
12/11/2011,12,Algeria,Algeria,Tunisia,Tunisia,1,0,Friendly,Algiers,Algeria,2011,1,11,1,-1,1,1,winner,loser,1564,7,1,1,0.18868152,0.969316671
15/11/2011,15,Jordan,Jordan,Iraq,Iraq,1,3,FIFA World Cup qualification,Amman,Jordan,2011,1,11,-2,2,2,4,loser,winner,1565,7,1,0,0.17895502,0.033001756
06/01/2001,6,Egypt,Egypt,UAE,UAE,2,1,Friendly,Cairo,Egypt,2001,1,1,1,-1,1,3,winner,loser,985,6,1,0,0.12454762,0.439567567
15/11/2011,15,Qatar,Qatar,Bahrain,Bahrain,0,0,FIFA World Cup qualification,Doha,Qatar,2011,1,11,0,0,0,0,draw,draw,1567,7,1,0,0.89598227,0.220776744
11/10/2005,11,UAE,UAE,Oman,Oman,2,2,Friendly,Al Ain,United Arab Emirates,2005,5,10,0,0,0,4,draw,draw,1246,6,0,1,0.64790867,0.039810339
06/12/2011,6,Bahrain,Bahrain,Palestine,Palestine,0,1,Friendly,Arad,Bahrain,2011,1,12,-1,1,1,1,loser,winner,1569,7,0,0,0.10605765,0.004055926
09/01/2012,9,Tunisia,Tunisia,Sudan,Sudan,3,0,Friendly,Sharjah,United Arab Emirates,2012,2,1,3,-3,3,3,winner,loser,1570,7,1,1,0.00345344,0.459668021
22/01/2012,22,Lebanon,Lebanon,Iraq,Iraq,1,0,Friendly,Beirut,Lebanon,2012,2,1,1,-1,1,1,winner,loser,1571,7,1,0,0.63139412,0.135561175
23/01/2012,23,Morocco,Morocco,Tunisia,Tunisia,1,2,African Cup of Nations,Libreville,Gabon,2012,2,1,-1,1,1,3,loser,winner,1572,7,0,1,0.00533467,0.271692578
02/12/2005,2,UAE,UAE,Libya,Libya,1,1,Friendly,Sharjah,United Arab Emirates,2005,5,12,0,0,0,2,draw,draw,1254,6,0,0,0.19157465,0.290616496
22/02/2006,22,UAE,UAE,Oman,Oman,1,0,AFC Asian Cup qualification,Dubai,United Arab Emirates,2006,6,2,1,-1,1,1,winner,loser,1276,6,0,1,0.34838521,0.475545264
15/04/2012,15,Egypt,Egypt,Mauritania,Mauritania,3,0,Friendly,Dubai,United Arab Emirates,2012,2,4,3,-3,3,3,winner,loser,1575,7,1,1,0.99344717,0.65805119
17/04/2012,17,Egypt,Egypt,Iraq,Iraq,0,0,Friendly,Dubai,United Arab Emirates,2012,2,4,0,0,0,0,draw,draw,1576,7,1,0,0.2487806,0.098916175
11/05/2012,11,Lebanon,Lebanon,Egypt,Egypt,1,4,Friendly,Tripoli,Lebanon,2012,2,5,-3,3,3,5,loser,winner,1577,7,1,1,0.32683447,0.554051337
18/05/2012,18,Lebanon,Lebanon,Jordan,Jordan,1,2,Friendly,Sidon,Lebanon,2012,2,5,-1,1,1,3,loser,winner,1578,7,1,1,0.24222187,0.85396464
27/05/2012,27,Oman,Oman,Lebanon,Lebanon,1,1,Friendly,Muscat,Oman,2012,2,5,0,0,0,2,draw,draw,1579,7,1,1,0.88941383,0.342710874
28/05/2012,28,Qatar,Qatar,Palestine,Palestine,0,0,Friendly,Doha,Qatar,2012,2,5,0,0,0,0,draw,draw,1580,7,1,0,0.39713365,0.023386106
03/06/2012,3,Jordan,Jordan,Iraq,Iraq,1,1,FIFA World Cup qualification,Amman,Jordan,2012,2,6,0,0,0,2,draw,draw,1581,7,1,0,0.76148834,0.711432194
03/06/2012,3,Lebanon,Lebanon,Qatar,Qatar,0,1,FIFA World Cup qualification,Beirut,Lebanon,2012,2,6,-1,1,1,1,loser,winner,1582,7,1,1,0.69603164,0.181233411
08/06/2012,8,Bahrain,Bahrain,Kuwait,Kuwait,1,1,Friendly,6th of October City,Egypt,2012,2,6,0,0,0,2,draw,draw,1583,7,0,0,0.31666103,0.008521049
12/06/2012,12,Bahrain,Bahrain,Kuwait,Kuwait,0,1,Friendly,6th of October City,Egypt,2012,2,6,-1,1,1,1,loser,winner,1584,7,0,0,0.30937816,0.733729318
12/06/2012,12,Iraq,Iraq,Oman,Oman,1,1,FIFA World Cup qualification,Doha,Qatar,2012,2,6,0,0,0,2,draw,draw,1585,7,0,1,0.75346837,0.427658545
02/05/2006,2,UAE,UAE,Syria,Syria,2,1,Friendly,Dubai,United Arab Emirates,2006,6,5,1,-1,1,3,winner,loser,1281,6,0,0,0.1264713,0.999326301
18/06/2012,18,Yemen,Yemen,Palestine,Palestine,1,2,Friendly,Sana'a,Yemen,2012,2,6,-1,1,1,3,loser,winner,1587,7,1,0,0.09012563,0.067064264
06/09/2006,6,UAE,UAE,Jordan,Jordan,0,0,AFC Asian Cup qualification,Sharjah,United Arab Emirates,2006,6,9,0,0,0,0,draw,draw,1299,6,0,1,0.49350281,0.432620583
23/06/2012,23,Libya,Libya,Yemen,Yemen,3,1,UAFA Cup,Jeddah,Saudi Arabia,2012,2,6,2,-2,2,4,winner,loser,1589,7,0,1,0.93296966,0.307357302
23/06/2012,23,Morocco,Morocco,Bahrain,Bahrain,4,0,UAFA Cup,Jeddah,Saudi Arabia,2012,2,6,4,-4,4,4,winner,loser,1590,7,0,0,0.20847724,0.177185943
24/06/2012,24,Iraq,Iraq,Lebanon,Lebanon,1,0,UAFA Cup,Jeddah,Saudi Arabia,2012,2,6,1,-1,1,1,winner,loser,1591,7,0,1,0.63861748,0.192194731
25/06/2012,25,Kuwait,Kuwait,Palestine,Palestine,2,0,UAFA Cup,Ta’if,Saudi Arabia,2012,2,6,2,-2,2,2,winner,loser,1592,7,0,0,0.7949461,0.51049792
26/06/2012,26,Bahrain,Bahrain,Yemen,Yemen,0,2,UAFA Cup,Jeddah,Saudi Arabia,2012,2,6,-2,2,2,2,loser,winner,1593,7,0,1,0.83141064,0.682328367
26/06/2012,26,Libya,Libya,Morocco,Morocco,0,0,UAFA Cup,Jeddah,Saudi Arabia,2012,2,6,0,0,0,0,draw,draw,1594,7,0,0,0.96155716,0.801845844
27/06/2012,27,Lebanon,Lebanon,Sudan,Sudan,0,2,UAFA Cup,Jeddah,Saudi Arabia,2012,2,6,-2,2,2,2,loser,winner,1595,7,1,1,0.49590999,0.615653525
17/01/2007,17,UAE,UAE,Oman,Oman,1,2,Gulf Cup,Abu Dhabi,United Arab Emirates,2007,7,1,-1,1,1,3,loser,winner,1322,6,0,1,0.08029866,0.821836195
29/06/2012,29,Libya,Libya,Bahrain,Bahrain,2,1,UAFA Cup,Ta’if,Saudi Arabia,2012,2,6,1,-1,1,3,winner,loser,1597,7,0,0,0.98990747,0.458228205
29/06/2012,29,Yemen,Yemen,Morocco,Morocco,0,4,UAFA Cup,Jeddah,Saudi Arabia,2012,2,6,-4,4,4,4,loser,winner,1598,7,1,0,0.9098616,0.826999902
30/06/2012,30,Sudan,Sudan,Iraq,Iraq,1,1,UAFA Cup,Jeddah,Saudi Arabia,2012,2,6,0,0,0,2,draw,draw,1599,7,1,0,0.83151063,0.928165022
03/07/2012,3,Morocco,Morocco,Iraq,Iraq,2,1,UAFA Cup,Jeddah,Saudi Arabia,2012,2,7,1,-1,1,3,winner,loser,1600,7,0,0,0.4939446,0.22988997
20/01/2007,20,UAE,UAE,Yemen,Yemen,2,1,Gulf Cup,Abu Dhabi,United Arab Emirates,2007,7,1,1,-1,1,3,winner,loser,1326,6,0,1,0.76157037,0.904299784
23/01/2007,23,UAE,UAE,Kuwait,Kuwait,3,2,Gulf Cup,Abu Dhabi,United Arab Emirates,2007,7,1,1,-1,1,5,winner,loser,1330,6,0,0,0.90190444,0.980959773
06/07/2012,6,Libya,Libya,Morocco,Morocco,1,1,UAFA Cup,Jeddah,Saudi Arabia,2012,2,7,0,0,0,2,draw,draw,1603,7,0,0,0.13812529,0.048198681
15/08/2012,15,Oman,Oman,Egypt,Egypt,1,1,Friendly,Salalah,Oman,2012,2,8,0,0,0,2,draw,draw,1604,7,1,1,0.36207742,0.441548414
26/08/2012,26,Libya,Libya,Sudan,Sudan,3,0,Friendly,Tunis,Tunisia,2012,2,8,3,-3,3,3,winner,loser,1605,7,0,1,0.30750529,0.881160134
09/09/2012,9,Libya,Libya,Algeria,Algeria,0,1,African Cup of Nations qualification,Casablanca,Morocco,2012,2,9,-1,1,1,1,loser,winner,1606,7,0,1,0.73546475,0.592506378
27/03/2001,27,Oman,Oman,UAE,UAE,2,1,Friendly,Muscat,Oman,2001,1,3,1,-1,1,3,winner,loser,1002,6,1,0,0.57270962,0.882183737
28/09/2012,28,Oman,Oman,Yemen,Yemen,2,1,Friendly,Muscat,Oman,2012,2,9,1,-1,1,3,winner,loser,1608,7,1,1,0.11699948,0.720951437
11/10/2012,11,Kuwait,Kuwait,Syria,Syria,1,1,Friendly,Muscat,Oman,2012,2,10,0,0,0,2,draw,draw,1609,7,0,0,0.30421049,0.64144426
16/10/2012,16,Egypt,Egypt,Tunisia,Tunisia,0,1,Friendly,Abu Dhabi,United Arab Emirates,2012,2,10,-1,1,1,1,loser,winner,1610,7,1,1,0.30254235,0.534654549
16/10/2012,16,Lebanon,Lebanon,Yemen,Yemen,2,1,Friendly,Beirut,Lebanon,2012,2,10,1,-1,1,3,winner,loser,1611,7,1,1,0.2588443,0.085918641
16/10/2012,16,Oman,Oman,Jordan,Jordan,2,1,FIFA World Cup qualification,Muscat,Oman,2012,2,10,1,-1,1,3,winner,loser,1612,7,1,1,0.17779294,0.277711947
30/01/2007,30,UAE,UAE,Oman,Oman,1,0,Gulf Cup,Abu Dhabi,United Arab Emirates,2007,7,1,1,-1,1,1,winner,loser,1335,6,0,1,0.47803664,0.216726661
08/11/2012,8,Bahrain,Bahrain,Jordan,Jordan,3,0,Friendly,Arad,Bahrain,2012,2,11,3,-3,3,3,winner,loser,1614,7,0,1,0.10918132,0.343101444
14/11/2012,14,Iraq,Iraq,Jordan,Jordan,1,0,FIFA World Cup qualification,Doha,Qatar,2012,2,11,1,-1,1,1,winner,loser,1615,7,0,1,0.21423522,0.747697869
14/11/2012,14,Kuwait,Kuwait,Bahrain,Bahrain,1,1,Friendly,Kuwait City,Kuwait,2012,2,11,0,0,0,2,draw,draw,1616,7,0,0,0.89160794,0.505744221
14/11/2012,14,Qatar,Qatar,Lebanon,Lebanon,1,0,FIFA World Cup qualification,Doha,Qatar,2012,2,11,1,-1,1,1,winner,loser,1617,7,1,1,0.29571066,0.74301535
17/11/2012,17,Palestine,Palestine,Syria,Syria,1,1,Friendly,Amman,Jordan,2012,2,11,0,0,0,2,draw,draw,1618,7,0,0,0.68902966,0.736515277
20/11/2012,20,Palestine,Palestine,Syria,Syria,2,1,Friendly,Zarqa,Jordan,2012,2,11,1,-1,1,3,winner,loser,1619,7,0,0,0.61307938,0.871281237
28/11/2012,28,Somalia,Somalia,Sudan,Sudan,0,1,CECAFA Cup,Kampala,Uganda,2012,2,11,-1,1,1,1,loser,winner,1620,7,1,1,0.69367847,0.819965457
29/11/2012,29,Palestine,Palestine,Bahrain,Bahrain,0,2,Friendly,al-Wakrah,Qatar,2012,2,11,-2,2,2,2,loser,winner,1621,7,0,0,0.4213742,0.62806802
08/12/2012,8,Kuwait,Kuwait,Palestine,Palestine,2,1,WAFF Championship,Kuwait City,Kuwait,2012,2,12,1,-1,1,3,winner,loser,1622,7,0,0,0.92349249,0.575303589
08/12/2012,8,Oman,Oman,Lebanon,Lebanon,0,1,WAFF Championship,al-Farwaniyah,Kuwait,2012,2,12,-1,1,1,1,loser,winner,1623,7,1,1,0.01314686,0.781687692
09/12/2012,9,Bahrain,Bahrain,Yemen,Yemen,1,0,WAFF Championship,al-Farwaniyah,Kuwait,2012,2,12,1,-1,1,1,winner,loser,1624,7,0,1,0.17630108,0.512684818
10/12/2012,10,Iraq,Iraq,Jordan,Jordan,1,0,WAFF Championship,al-Farwaniyah,Kuwait,2012,2,12,1,-1,1,1,winner,loser,1625,7,0,1,0.13523975,0.890020625
11/12/2012,11,Kuwait,Kuwait,Oman,Oman,0,2,WAFF Championship,Kuwait City,Kuwait,2012,2,12,-2,2,2,2,loser,winner,1626,7,0,1,0.19978497,0.523966242
11/12/2012,11,Lebanon,Lebanon,Palestine,Palestine,0,1,WAFF Championship,al-Farwaniyah,Kuwait,2012,2,12,-1,1,1,1,loser,winner,1627,7,1,0,0.16827055,0.327878615
11/05/2001,11,Yemen,Yemen,UAE,UAE,2,1,FIFA World Cup qualification,Sana'a,Yemen,2001,1,5,1,-1,1,3,winner,loser,1008,6,1,0,0.29371757,0.695745631
13/12/2012,13,Iraq,Iraq,Syria,Syria,1,1,WAFF Championship,Kuwait City,Kuwait,2012,2,12,0,0,0,2,draw,draw,1629,7,0,0,0.75181684,0.668553794
14/12/2012,14,Kuwait,Kuwait,Lebanon,Lebanon,2,1,WAFF Championship,Kuwait City,Kuwait,2012,2,12,1,-1,1,3,winner,loser,1630,7,0,1,0.23702871,0.590881396
14/12/2012,14,Oman,Oman,Palestine,Palestine,2,1,WAFF Championship,al-Farwaniyah,Kuwait,2012,2,12,1,-1,1,3,winner,loser,1631,7,1,0,0.38710011,0.565623293
23/11/2014,23,Saudi Arabia,Saudi_Arabia,UAE,UAE,3,2,Gulf Cup,Riyadh,Saudi Arabia,2014,4,11,1,-1,1,5,winner,loser,1739,7,0,0,0.65289478,0.004088971
16/12/2012,16,Syria,Syria,Jordan,Jordan,2,1,WAFF Championship,Kuwait City,Kuwait,2012,2,12,1,-1,1,3,winner,loser,1633,7,0,1,0.10082659,0.782153775
18/12/2012,18,Bahrain,Bahrain,Syria,Syria,1,1,WAFF Championship,Kuwait City,Kuwait,2012,2,12,0,0,0,2,draw,draw,1634,7,0,0,0.17971975,0.627342713
18/12/2012,18,Oman,Oman,Iraq,Iraq,0,2,WAFF Championship,al-Farwaniyah,Kuwait,2012,2,12,-2,2,2,2,loser,winner,1635,7,1,0,0.53683302,0.802701668
20/12/2012,20,Iraq,Iraq,Syria,Syria,0,1,WAFF Championship,Kuwait City,Kuwait,2012,2,12,-1,1,1,1,loser,winner,1636,7,0,0,0.36490935,0.748697205
20/12/2012,20,Oman,Oman,Bahrain,Bahrain,1,0,WAFF Championship,Kuwait City,Kuwait,2012,2,12,1,-1,1,1,winner,loser,1637,7,1,0,0.36730973,0.122403074
08/10/2015,8,Saudi Arabia,Saudi_Arabia,UAE,UAE,2,1,FIFA World Cup qualification,Jeddah,Saudi Arabia,2015,5,10,1,-1,1,3,winner,loser,1779,7,0,0,0.35506242,0.579898894
28/12/2012,28,Qatar,Qatar,Egypt,Egypt,0,2,Friendly,Doha,Qatar,2012,2,12,-2,2,2,2,loser,winner,1639,7,1,1,0.46795846,0.582460143
27/06/2007,27,UAE,UAE,Bahrain,Bahrain,2,2,Friendly,Petaling Jaya,Malaysia,2007,7,6,0,0,0,4,draw,draw,1350,6,0,0,0.95429712,0.858262521
30/12/2012,30,Iraq,Iraq,Tunisia,Tunisia,1,2,Friendly,Baghdad,Iraq,2012,2,12,-1,1,1,3,loser,winner,1641,7,0,1,0.49252042,0.534949794
05/01/2013,5,Bahrain,Bahrain,Oman,Oman,0,0,Gulf Cup,Riffa,Bahrain,2013,3,1,0,0,0,0,draw,draw,1642,7,0,1,0.56374839,0.58775909
11/10/2016,11,Saudi Arabia,Saudi_Arabia,UAE,UAE,3,0,FIFA World Cup qualification,Jeddah,Saudi Arabia,2016,6,10,3,-3,3,3,winner,loser,1811,7,0,0,0.46871234,0.471283591
06/01/2013,6,Kuwait,Kuwait,Yemen,Yemen,2,0,Gulf Cup,Isa Town,Bahrain,2013,3,1,2,-2,2,2,winner,loser,1644,7,0,1,0.94929569,0.566790844
23/09/2007,23,UAE,UAE,Lebanon,Lebanon,1,1,Friendly,Dubai,United Arab Emirates,2007,7,9,0,0,0,2,draw,draw,1360,6,0,1,0.899661,0.389307139
14/09/2001,14,Oman,Oman,UAE,UAE,1,1,FIFA World Cup qualification,Muscat,Oman,2001,1,9,0,0,0,2,draw,draw,1026,6,1,0,0.99743606,0.785363404
08/01/2013,8,Qatar,Qatar,Oman,Oman,2,1,Gulf Cup,Riffa,Bahrain,2013,3,1,1,-1,1,3,winner,loser,1647,7,1,1,0.35881683,0.179007458
09/01/2013,9,Iraq,Iraq,Kuwait,Kuwait,1,0,Gulf Cup,Isa Town,Bahrain,2013,3,1,1,-1,1,1,winner,loser,1648,7,0,0,0.65642065,0.31005773
04/10/2001,4,Qatar,Qatar,UAE,UAE,1,2,FIFA World Cup qualification,Doha,Qatar,2001,1,10,-1,1,1,3,loser,winner,1031,6,1,0,0.54017297,0.006354208
11/01/2013,11,Bahrain,Bahrain,Qatar,Qatar,1,0,Gulf Cup,Riffa,Bahrain,2013,3,1,1,-1,1,1,winner,loser,1650,7,0,1,0.68921211,0.079354422
17/10/2007,17,UAE,UAE,Tunisia,Tunisia,0,1,Friendly,Abu Dhabi,United Arab Emirates,2007,7,10,-1,1,1,1,loser,winner,1363,6,0,1,0.34017458,0.313283488
12/01/2013,12,Iraq,Iraq,Yemen,Yemen,2,0,Gulf Cup,Isa Town,Bahrain,2013,3,1,2,-2,2,2,winner,loser,1652,7,0,1,0.84479809,0.791523363
29/01/2002,29,Kuwait,Kuwait,UAE,UAE,2,1,Gulf Cup,Riyadh,Saudi Arabia,2002,2,1,1,-1,1,3,winner,loser,1058,6,0,0,0.31945985,0.659150993
15/01/2013,15,Bahrain,Bahrain,Iraq,Iraq,1,1,Gulf Cup,Riffa,Bahrain,2013,3,1,0,0,0,2,draw,draw,1654,7,0,0,0.7648912,0.972762205
31/01/2008,31,UAE,UAE,Iraq,Iraq,0,1,Friendly,Abu Dhabi,United Arab Emirates,2008,8,1,-1,1,1,1,loser,winner,1375,6,0,0,0.29621346,0.746348877
18/01/2013,18,Bahrain,Bahrain,Kuwait,Kuwait,1,6,Gulf Cup,Isa Town,Bahrain,2013,3,1,-5,5,5,7,loser,winner,1656,7,0,0,0.5578235,0.186356924
06/02/2008,6,UAE,UAE,Kuwait,Kuwait,2,0,FIFA World Cup qualification,Abu Dhabi,United Arab Emirates,2008,8,2,2,-2,2,2,winner,loser,1377,6,0,0,0.19027526,0.73908078
22/01/2013,22,Tunisia,Tunisia,Algeria,Algeria,1,0,African Cup of Nations,Rustenburg,South Africa,2013,3,1,1,-1,1,1,winner,loser,1658,7,1,1,0.49309317,0.791432413
31/01/2013,31,Qatar,Qatar,Lebanon,Lebanon,1,0,Friendly,Doha,Qatar,2013,3,1,1,-1,1,1,winner,loser,1659,7,1,1,0.72707428,0.131266509
06/02/2013,6,Oman,Oman,Syria,Syria,1,0,AFC Asian Cup qualification,Muscat,Oman,2013,3,2,1,-1,1,1,winner,loser,1660,7,1,0,0.77154253,0.812075368
06/02/2013,6,Yemen,Yemen,Bahrain,Bahrain,0,2,AFC Asian Cup qualification,Sharjah,United Arab Emirates,2013,3,2,-2,2,2,2,loser,winner,1661,7,1,0,0.57722298,0.739189304
07/03/2013,7,Qatar,Qatar,Egypt,Egypt,3,1,Friendly,Doha,Qatar,2013,3,3,2,-2,2,4,winner,loser,1662,7,1,1,0.78982865,0.547492875
17/03/2013,17,Bahrain,Bahrain,Lebanon,Lebanon,0,0,Friendly,Riffa,Bahrain,2013,3,3,0,0,0,0,draw,draw,1663,7,0,1,0.86568368,0.755993065
21/03/2013,21,Kuwait,Kuwait,Palestine,Palestine,2,1,Friendly,Kuwait City,Kuwait,2013,3,3,1,-1,1,3,winner,loser,1664,7,0,0,0.54009261,0.125270602
22/03/2013,22,Bahrain,Bahrain,Qatar,Qatar,1,0,AFC Asian Cup qualification,Riffa,Bahrain,2013,3,3,1,-1,1,1,winner,loser,1665,7,0,1,0.83062187,0.899477479
26/03/2013,26,Iraq,Iraq,Syria,Syria,2,1,Friendly,Baghdad,Iraq,2013,3,3,1,-1,1,3,winner,loser,1666,7,0,0,0.52198498,0.043843449
17/04/2013,17,Qatar,Qatar,Palestine,Palestine,2,0,Friendly,Doha,Qatar,2013,3,4,2,-2,2,2,winner,loser,1667,7,1,0,0.26714925,0.317711712
13/05/2013,13,Libya,Libya,Mauritania,Mauritania,2,0,Friendly,Tripoli,Libya,2013,3,5,2,-2,2,2,winner,loser,1668,7,0,1,0.80687085,0.422308399
25/05/2013,25,Algeria,Algeria,Mauritania,Mauritania,1,0,Friendly,Blida,Algeria,2013,3,5,1,-1,1,1,winner,loser,1669,7,1,1,0.35446995,0.955900184
27/05/2013,27,Jordan,Jordan,Libya,Libya,1,0,Friendly,Amman,Jordan,2013,3,5,1,-1,1,1,winner,loser,1670,7,1,0,0.15360473,0.74099043
29/05/2013,29,Oman,Oman,Lebanon,Lebanon,1,1,Friendly,Doha,Qatar,2013,3,5,0,0,0,2,draw,draw,1671,7,1,1,0.51860327,0.486695328
04/06/2013,4,Oman,Oman,Iraq,Iraq,1,0,FIFA World Cup qualification,Muscat,Oman,2013,3,6,1,-1,1,1,winner,loser,1672,7,1,0,0.12541309,0.387235164
18/06/2013,18,Jordan,Jordan,Oman,Oman,1,0,FIFA World Cup qualification,Amman,Jordan,2013,3,6,1,-1,1,1,winner,loser,1673,7,1,1,0.09774031,0.345430488
13/07/2013,13,Morocco,Morocco,Tunisia,Tunisia,0,0,African Nations Championship,Tangier,Morocco,2013,3,7,0,0,0,0,draw,draw,1674,7,0,1,0.38888245,0.414440326
09/08/2013,9,Jordan,Jordan,Libya,Libya,2,1,Friendly,Amman,Jordan,2013,3,8,1,-1,1,3,winner,loser,1675,7,1,0,0.70262535,0.827804431
15/08/2013,15,Syria,Syria,Jordan,Jordan,1,1,AFC Asian Cup qualification,Teheran,Iran,2013,3,8,0,0,0,2,draw,draw,1676,7,0,1,0.48699148,0.956984867
06/09/2013,6,Lebanon,Lebanon,Syria,Syria,2,0,Friendly,Beirut,Lebanon,2013,3,9,2,-2,2,2,winner,loser,1677,7,1,0,0.39535396,0.099774281
09/09/2013,9,Kuwait,Kuwait,Bahrain,Bahrain,2,1,Friendly,Kuwait City,Kuwait,2013,3,9,1,-1,1,3,winner,loser,1678,7,0,0,0.74278339,0.725506369
09/09/2013,9,Qatar,Qatar,Lebanon,Lebanon,1,1,Friendly,Doha,Qatar,2013,3,9,0,0,0,2,draw,draw,1679,7,1,1,0.14787588,0.188304876
06/10/2013,6,Iraq,Iraq,Yemen,Yemen,3,2,Friendly,Beirut,Lebanon,2013,3,10,1,-1,1,5,winner,loser,1680,7,0,1,0.18531885,0.486431
08/10/2013,8,Lebanon,Lebanon,Iraq,Iraq,1,1,Friendly,Beirut,Lebanon,2013,3,10,0,0,0,2,draw,draw,1681,7,1,0,0.23083769,0.976465637
09/10/2013,9,Jordan,Jordan,Kuwait,Kuwait,1,1,Friendly,Amman,Jordan,2013,3,10,0,0,0,2,draw,draw,1682,7,1,0,0.02379014,0.953663026
09/10/2013,9,Oman,Oman,Mauritania,Mauritania,0,0,Friendly,Muscat,Oman,2013,3,10,0,0,0,0,draw,draw,1683,7,1,1,0.94551959,0.268186929
13/10/2013,13,Qatar,Qatar,Yemen,Yemen,6,0,AFC Asian Cup qualification,Doha,Qatar,2013,3,10,6,-6,6,6,winner,loser,1684,7,1,1,0.87977852,0.094061763
25/09/2002,25,Oman,Oman,UAE,UAE,2,1,Friendly,Muscat,Oman,2002,2,9,1,-1,1,3,winner,loser,1072,6,1,0,0.10376491,0.165226048
15/10/2013,15,Jordan,Jordan,Oman,Oman,0,0,AFC Asian Cup qualification,Amman,Jordan,2013,3,10,0,0,0,0,draw,draw,1686,7,1,1,0.92538541,0.949336976
15/10/2013,15,Lebanon,Lebanon,Kuwait,Kuwait,1,1,AFC Asian Cup qualification,Beirut,Lebanon,2013,3,10,0,0,0,2,draw,draw,1687,7,1,0,0.25513831,0.515723863
09/11/2013,9,Bahrain,Bahrain,Lebanon,Lebanon,1,0,Friendly,Riffa,Bahrain,2013,3,11,1,-1,1,1,winner,loser,1688,7,0,1,0.09393803,0.561118023
15/11/2013,15,Kuwait,Kuwait,Lebanon,Lebanon,0,0,AFC Asian Cup qualification,Kuwait City,Kuwait,2013,3,11,0,0,0,0,draw,draw,1689,7,0,1,0.36246534,0.703567096
22/06/2008,22,UAE,UAE,Syria,Syria,1,3,FIFA World Cup qualification,Al Ain,United Arab Emirates,2008,8,6,-2,2,2,4,loser,winner,1400,6,0,0,0.30810889,0.087466652
15/11/2013,15,Yemen,Yemen,Qatar,Qatar,1,4,AFC Asian Cup qualification,al-Ain,United Arab Emirates,2013,3,11,-3,3,3,5,loser,winner,1691,7,1,1,0.58194075,0.414585669
19/11/2013,19,Bahrain,Bahrain,Yemen,Yemen,2,0,AFC Asian Cup qualification,Riffa,Bahrain,2013,3,11,2,-2,2,2,winner,loser,1692,7,0,1,0.15594827,0.921046751
19/11/2013,19,Syria,Syria,Oman,Oman,0,1,AFC Asian Cup qualification,Teheran,Iran,2013,3,11,-1,1,1,1,loser,winner,1693,7,0,1,0.79580504,0.680255438
21/12/2013,21,Qatar,Qatar,Bahrain,Bahrain,1,1,Friendly,Doha,Qatar,2013,3,12,0,0,0,2,draw,draw,1694,7,1,0,0.67957919,0.969264456
25/12/2013,25,Oman,Oman,Bahrain,Bahrain,0,0,WAFF Championship,Doha,Qatar,2013,3,12,0,0,0,0,draw,draw,1695,7,1,0,0.46877977,0.026654706
25/12/2013,25,Qatar,Qatar,Palestine,Palestine,1,0,WAFF Championship,Doha,Qatar,2013,3,12,1,-1,1,1,winner,loser,1696,7,1,0,0.30501043,0.572902553
26/12/2013,26,Jordan,Jordan,Lebanon,Lebanon,0,0,WAFF Championship,Doha,Qatar,2013,3,12,0,0,0,0,draw,draw,1697,7,1,1,0.09717062,0.081895642
28/12/2013,28,Bahrain,Bahrain,Iraq,Iraq,0,0,WAFF Championship,Doha,Qatar,2013,3,12,0,0,0,0,draw,draw,1698,7,0,0,0.94253915,0.244950066
07/11/2003,7,Syria,Syria,UAE,UAE,1,3,AFC Asian Cup qualification,Damascus,Syria,2003,3,11,-2,2,2,4,loser,winner,1123,6,0,0,0.83003795,0.408090178
29/12/2013,29,Lebanon,Lebanon,Kuwait,Kuwait,0,2,WAFF Championship,Doha,Qatar,2013,3,12,-2,2,2,2,loser,winner,1700,7,1,0,0.3589107,0.716308191
31/12/2013,31,Iraq,Iraq,Oman,Oman,0,0,WAFF Championship,Doha,Qatar,2013,3,12,0,0,0,0,draw,draw,1701,7,0,1,0.72680106,0.017831543
29/12/2003,29,Kuwait,Kuwait,UAE,UAE,0,2,Gulf Cup,Kuwait City,Kuwait,2003,3,12,-2,2,2,2,loser,winner,1136,6,0,0,0.92179396,0.408510123
01/01/2014,1,Kuwait,Kuwait,Jordan,Jordan,1,2,WAFF Championship,Doha,Qatar,2014,4,1,-1,1,1,3,loser,winner,1703,7,0,1,0.17151191,0.997879473
04/01/2014,4,Bahrain,Bahrain,Jordan,Jordan,0,1,WAFF Championship,Doha,Qatar,2014,4,1,-1,1,1,1,loser,winner,1704,7,0,1,0.84161984,0.135573272
04/01/2014,4,Qatar,Qatar,Kuwait,Kuwait,3,0,WAFF Championship,Doha,Qatar,2014,4,1,3,-3,3,3,winner,loser,1705,7,1,0,0.42744554,0.644477818
07/01/2014,7,Bahrain,Bahrain,Kuwait,Kuwait,0,0,WAFF Championship,Doha,Qatar,2014,4,1,0,0,0,0,draw,draw,1706,7,0,0,0.08418832,0.38275254
07/01/2014,7,Qatar,Qatar,Jordan,Jordan,2,0,WAFF Championship,Doha,Qatar,2014,4,1,2,-2,2,2,winner,loser,1707,7,1,1,0.7779113,0.014182848
31/01/2014,31,Oman,Oman,Jordan,Jordan,0,0,AFC Asian Cup qualification,Muscat,Oman,2014,4,1,0,0,0,0,draw,draw,1708,7,1,1,0.70622149,0.21028955
05/03/2014,5,Jordan,Jordan,Syria,Syria,2,1,AFC Asian Cup qualification,Amman,Jordan,2014,4,3,1,-1,1,3,winner,loser,1709,7,1,0,0.93340659,0.40495705
05/03/2014,5,Qatar,Qatar,Bahrain,Bahrain,0,0,AFC Asian Cup qualification,Doha,Qatar,2014,4,3,0,0,0,0,draw,draw,1710,7,1,0,0.93685321,0.497752737
03/09/2014,3,Morocco,Morocco,Qatar,Qatar,0,0,Friendly,Rabat,Morocco,2014,4,9,0,0,0,0,draw,draw,1711,7,0,1,0.0336569,0.940205973
07/09/2014,7,Morocco,Morocco,Libya,Libya,3,0,Friendly,Marrakech,Morocco,2014,4,9,3,-3,3,3,winner,loser,1712,7,0,0,0.22541914,0.727224855
09/09/2014,9,Kuwait,Kuwait,Bahrain,Bahrain,0,1,Friendly,al-Farwaniyah,Kuwait,2014,4,9,-1,1,1,1,loser,winner,1713,7,0,0,0.12427463,0.863709166
10/09/2014,10,Egypt,Egypt,Tunisia,Tunisia,0,1,African Cup of Nations qualification,Cairo,Egypt,2014,4,9,-1,1,1,1,loser,winner,1714,7,1,1,0.99336324,0.926956385
09/10/2014,9,Qatar,Qatar,Lebanon,Lebanon,5,0,Friendly,Doha,Qatar,2014,4,10,5,-5,5,5,winner,loser,1715,7,1,1,0.39707603,0.693306112
10/10/2014,10,Jordan,Jordan,Kuwait,Kuwait,0,1,Friendly,Amman,Jordan,2014,4,10,-1,1,1,1,loser,winner,1716,7,1,0,0.9329057,0.110904488
10/10/2014,10,Yemen,Yemen,Iraq,Iraq,1,1,Friendly,Manama,Bahrain,2014,4,10,0,0,0,2,draw,draw,1717,7,1,0,0.2191945,0.773915012
13/10/2014,13,Jordan,Jordan,Kuwait,Kuwait,1,1,Friendly,Amman,Jordan,2014,4,10,0,0,0,2,draw,draw,1718,7,1,0,0.49032218,0.437743692
14/10/2014,14,Bahrain,Bahrain,Iraq,Iraq,0,0,Friendly,Riffa,Bahrain,2014,4,10,0,0,0,0,draw,draw,1719,7,0,0,0.21007531,0.663926547
29/08/2008,29,UAE,UAE,Bahrain,Bahrain,2,3,Friendly,Abu Dhabi,United Arab Emirates,2008,8,8,-1,1,1,5,loser,winner,1407,6,0,0,0.26082266,0.604250231
04/11/2014,4,Kuwait,Kuwait,Yemen,Yemen,1,1,Friendly,Abu Dhabi,United Arab Emirates,2014,4,11,0,0,0,2,draw,draw,1721,7,0,1,0.25251023,0.259628165
31/12/2003,31,Oman,Oman,UAE,UAE,2,0,Gulf Cup,Kuwait City,Kuwait,2003,3,12,2,-2,2,2,winner,loser,1139,6,1,0,0.17010491,0.908865594
27/12/2008,27,UAE,UAE,Iraq,Iraq,2,2,Friendly,Al Ain,United Arab Emirates,2008,8,12,0,0,0,4,draw,draw,1419,6,0,0,0.08407871,0.006750538
07/11/2014,7,Oman,Oman,Yemen,Yemen,2,0,Friendly,Muscat,Oman,2014,4,11,2,-2,2,2,winner,loser,1724,7,1,1,0.78486352,0.214949674
30/12/2008,30,UAE,UAE,Kuwait,Kuwait,0,0,Friendly,Dubai,United Arab Emirates,2008,8,12,0,0,0,0,draw,draw,1421,6,0,0,0.58812222,0.035271437
13/11/2014,13,Yemen,Yemen,Bahrain,Bahrain,0,0,Gulf Cup,Riyadh,Saudi Arabia,2014,4,11,0,0,0,0,draw,draw,1726,7,1,0,0.05428505,0.222723948
14/11/2014,14,Iraq,Iraq,Kuwait,Kuwait,0,1,Gulf Cup,Riyadh,Saudi Arabia,2014,4,11,-1,1,1,1,loser,winner,1727,7,0,0,0.18318933,0.628174178
05/01/2009,5,UAE,UAE,Yemen,Yemen,3,1,Gulf Cup,Muscat,Oman,2009,9,1,2,-2,2,4,winner,loser,1426,6,0,1,0.81803047,0.622990365
11/01/2004,11,Yemen,Yemen,UAE,UAE,0,3,Gulf Cup,Kuwait City,Kuwait,2004,4,1,-3,3,3,3,loser,winner,1152,6,1,0,0.48287227,0.569829135
16/11/2014,16,Yemen,Yemen,Qatar,Qatar,0,0,Gulf Cup,Riyadh,Saudi Arabia,2014,4,11,0,0,0,0,draw,draw,1730,7,1,1,0.97959512,0.251341874
17/11/2014,17,Iraq,Iraq,Oman,Oman,1,1,Gulf Cup,Riyadh,Saudi Arabia,2014,4,11,0,0,0,2,draw,draw,1731,7,0,1,0.84903947,0.789272054
10/10/2009,10,UAE,UAE,Palestine,Palestine,1,1,Friendly,Dubai,United Arab Emirates,2009,9,10,0,0,0,2,draw,draw,1460,6,0,0,0.69711249,0.399240333
19/11/2014,19,Bahrain,Bahrain,Qatar,Qatar,0,0,Gulf Cup,Riyadh,Saudi Arabia,2014,4,11,0,0,0,0,draw,draw,1733,7,0,1,0.55613763,0.955298187
14/10/2009,14,UAE,UAE,Jordan,Jordan,3,1,Friendly,Dubai,United Arab Emirates,2009,9,10,2,-2,2,4,winner,loser,1462,6,0,1,0.44854109,0.433796374
19/11/2014,19,Tunisia,Tunisia,Egypt,Egypt,2,1,African Cup of Nations qualification,Monastir,Tunisia,2014,4,11,1,-1,1,3,winner,loser,1735,7,1,1,0.98694409,0.791261687
20/11/2014,20,Kuwait,Kuwait,Oman,Oman,0,5,Gulf Cup,Riyadh,Saudi Arabia,2014,4,11,-5,5,5,5,loser,winner,1736,7,0,1,0.33968771,0.526926642
18/11/2009,18,UAE,UAE,Iraq,Iraq,0,1,Friendly,al-Ain,United Arab Emirates,2009,9,11,-1,1,1,1,loser,winner,1467,6,0,0,0.96732914,0.787369605
23/11/2014,23,Oman,Oman,Qatar,Qatar,1,3,Gulf Cup,Riyadh,Saudi Arabia,2014,4,11,-2,2,2,4,loser,winner,1738,7,1,1,0.44459113,0.656195446
07/09/2010,7,UAE,UAE,Kuwait,Kuwait,3,0,Friendly,Abu Dhabi,United Arab Emirates,2010,0,9,3,-3,3,3,winner,loser,1483,7,0,0,0.77008226,0.60043436
26/11/2010,26,UAE,UAE,Oman,Oman,0,0,Gulf Cup,Aden,Yemen,2010,0,11,0,0,0,0,draw,draw,1507,7,0,1,0.5166581,0.30546853
29/11/2010,29,UAE,UAE,Bahrain,Bahrain,3,1,Gulf Cup,Zinjibar,Yemen,2010,0,11,2,-2,2,4,winner,loser,1511,7,0,0,0.51543875,0.434904441
22/12/2014,22,Iraq,Iraq,Kuwait,Kuwait,1,1,Friendly,al-Hamriyah,United Arab Emirates,2014,4,12,0,0,0,2,draw,draw,1742,7,0,0,0.51868607,0.225882536
19/07/2004,19,Kuwait,Kuwait,UAE,UAE,3,1,AFC Asian Cup,Jinan,China PR,2004,4,7,2,-2,2,4,winner,loser,1183,6,0,0,0.62853166,0.096750533
27/07/2004,27,Jordan,Jordan,UAE,UAE,0,0,AFC Asian Cup,Beijing,China PR,2004,4,7,0,0,0,0,draw,draw,1187,6,1,0,0.26693892,0.986518109
31/12/2014,31,Qatar,Qatar,Oman,Oman,2,2,Friendly,Canberra,Australia,2014,4,12,0,0,0,4,draw,draw,1745,7,1,1,0.27932065,0.837557978
04/01/2015,4,Bahrain,Bahrain,Jordan,Jordan,1,0,Friendly,Ballarat,Australia,2015,5,1,1,-1,1,1,winner,loser,1746,7,0,1,0.17770482,0.129869344
11/01/2015,11,Tunisia,Tunisia,Algeria,Algeria,1,1,Friendly,Radès,Tunisia,2015,5,1,0,0,0,2,draw,draw,1747,7,1,1,0.077586,0.483175267
02/01/2011,2,UAE,UAE,Syria,Syria,2,0,Friendly,Al Ain,United Arab Emirates,2011,1,1,2,-2,2,2,winner,loser,1520,7,0,0,0.15895583,0.59341899
12/01/2015,12,Jordan,Jordan,Iraq,Iraq,0,1,AFC Asian Cup,Brisbane,Australia,2015,5,1,-1,1,1,1,loser,winner,1749,7,1,0,0.66851095,0.224765651
08/09/2004,8,Yemen,Yemen,UAE,UAE,3,1,FIFA World Cup qualification,Sana'a,Yemen,2004,4,9,2,-2,2,4,winner,loser,1195,6,1,0,0.20636289,0.785385694
16/01/2015,16,Palestine,Palestine,Jordan,Jordan,1,5,AFC Asian Cup,Melbourne,Australia,2015,5,1,-4,4,4,6,loser,winner,1751,7,0,1,0.04849408,0.055625172
17/01/2015,17,Oman,Oman,Kuwait,Kuwait,1,0,AFC Asian Cup,Newcastle,Australia,2015,5,1,1,-1,1,1,winner,loser,1752,7,1,0,0.53098606,0.968930212
19/01/2015,19,Qatar,Qatar,Bahrain,Bahrain,1,2,AFC Asian Cup,Sydney,Australia,2015,5,1,-1,1,1,3,loser,winner,1753,7,1,0,0.05740692,0.748784657
20/01/2015,20,Iraq,Iraq,Palestine,Palestine,2,0,AFC Asian Cup,Canberra,Australia,2015,5,1,2,-2,2,2,winner,loser,1754,7,0,0,0.30102665,0.670348581
10/12/2004,10,Qatar,Qatar,UAE,UAE,2,2,Gulf Cup,Doha,Qatar,2004,4,12,0,0,0,4,draw,draw,1214,6,1,0,0.75165521,0.489010591
26/03/2015,26,Jordan,Jordan,Syria,Syria,0,1,Friendly,Amman,Jordan,2015,5,3,-1,1,1,1,loser,winner,1756,7,1,0,0.03557489,0.763084762
26/03/2015,26,Qatar,Qatar,Algeria,Algeria,1,0,Friendly,Doha,Qatar,2015,5,3,1,-1,1,1,winner,loser,1757,7,1,1,0.11523659,0.597467955
30/03/2015,30,Oman,Oman,Algeria,Algeria,1,4,Friendly,Doha,Qatar,2015,5,3,-3,3,3,5,loser,winner,1758,7,1,1,0.76201369,0.963073444
15/01/2011,15,UAE,UAE,Iraq,Iraq,0,1,AFC Asian Cup,Rayyan,Qatar,2011,1,1,-1,1,1,1,loser,winner,1523,7,0,0,0.3182849,0.865575639
24/05/2015,24,Lebanon,Lebanon,Syria,Syria,2,2,Friendly,Sidon,Lebanon,2015,5,5,0,0,0,4,draw,draw,1760,7,1,0,0.50538603,0.041233478
30/05/2015,30,Bahrain,Bahrain,Oman,Oman,0,0,Friendly,Riffa,Bahrain,2015,5,5,0,0,0,0,draw,draw,1761,7,0,1,0.36293112,0.343885775
30/05/2015,30,Jordan,Jordan,Lebanon,Lebanon,0,0,Friendly,Irbid,Jordan,2015,5,5,0,0,0,0,draw,draw,1762,7,1,1,0.89366065,0.20799861
05/06/2015,5,Jordan,Jordan,Kuwait,Kuwait,2,2,Friendly,Istanbul,Turkey,2015,5,6,0,0,0,4,draw,draw,1763,7,1,0,0.57823655,0.774551846
05/06/2015,5,Oman,Oman,Syria,Syria,1,2,Friendly,Muscat,Oman,2015,5,6,-1,1,1,3,loser,winner,1764,7,1,0,0.42091084,0.008305935
11/06/2015,11,Lebanon,Lebanon,Kuwait,Kuwait,0,1,FIFA World Cup qualification,Sidon,Lebanon,2015,5,6,-1,1,1,1,loser,winner,1765,7,1,0,0.30883043,0.405116141
17/07/2011,17,UAE,UAE,Lebanon,Lebanon,6,2,Friendly,al-Ain,United Arab Emirates,2011,1,7,4,-4,4,8,winner,loser,1544,7,0,1,0.63843989,0.959335632
12/06/2015,12,Morocco,Morocco,Libya,Libya,1,0,African Cup of Nations qualification,Agadir,Morocco,2015,5,6,1,-1,1,1,winner,loser,1767,7,0,0,0.82360456,0.520321278
12/06/2015,12,Tunisia,Tunisia,Djibouti,Djibouti,8,1,African Cup of Nations qualification,Radès,Tunisia,2015,5,6,7,-7,7,9,winner,loser,1768,7,1,0,0.7325079,0.219833575
15/06/2015,15,Morocco,Morocco,Tunisia,Tunisia,1,1,African Nations Championship,Casablanca,Morocco,2015,5,6,0,0,0,2,draw,draw,1769,7,0,1,0.90578239,0.298058459
21/06/2015,21,Morocco,Morocco,Libya,Libya,3,0,African Nations Championship,Casablanca,Morocco,2015,5,6,3,-3,3,3,winner,loser,1770,7,0,0,0.56842175,0.098103149
26/08/2015,26,Lebanon,Lebanon,Iraq,Iraq,2,3,Friendly,Sidon,Lebanon,2015,5,8,-1,1,1,5,loser,winner,1771,7,1,0,0.84743125,0.796008196
28/08/2015,28,Oman,Oman,Yemen,Yemen,1,0,Friendly,Seeb,Oman,2015,5,8,1,-1,1,1,winner,loser,1772,7,1,1,0.64652814,0.962688682
31/08/2015,31,Lebanon,Lebanon,Palestine,Palestine,0,0,Friendly,Sidon,Lebanon,2015,5,8,0,0,0,0,draw,draw,1773,7,1,0,0.64311428,0.904927765
13/12/2004,13,Oman,Oman,UAE,UAE,2,1,Gulf Cup,Doha,Qatar,2004,4,12,1,-1,1,3,winner,loser,1217,6,1,0,0.13503777,0.853738975
08/09/2015,8,Yemen,Yemen,Bahrain,Bahrain,0,4,FIFA World Cup qualification,Doha,Qatar,2015,5,9,-4,4,4,4,loser,winner,1775,7,1,0,0.21066854,0.923531561
02/10/2015,2,Oman,Oman,Syria,Syria,2,1,Friendly,Muscat,Oman,2015,5,10,1,-1,1,3,winner,loser,1776,7,1,0,0.67996622,0.398096766
03/10/2015,3,Jordan,Jordan,Iraq,Iraq,3,0,Friendly,Amman,Jordan,2015,5,10,3,-3,3,3,winner,loser,1777,7,1,0,0.52461983,0.552830711
25/08/2011,25,UAE,UAE,Qatar,Qatar,3,1,Friendly,al-Ain,United Arab Emirates,2011,1,8,2,-2,2,4,winner,loser,1551,7,0,1,0.21210797,0.348843519
02/09/2011,2,UAE,UAE,Kuwait,Kuwait,2,3,FIFA World Cup qualification,al-Ain,United Arab Emirates,2011,1,9,-1,1,1,5,loser,winner,1557,7,0,0,0.3611242,0.524583505
13/10/2015,13,Kuwait,Kuwait,Lebanon,Lebanon,0,0,FIFA World Cup qualification,Kuwait City,Kuwait,2015,5,10,0,0,0,0,draw,draw,1780,7,0,1,0.20875583,0.115301319
16/12/2004,16,Iraq,Iraq,UAE,UAE,1,1,Gulf Cup,Rayyan,Qatar,2004,4,12,0,0,0,2,draw,draw,1221,6,0,0,0.25456881,0.572369507
19/10/2015,19,Tunisia,Tunisia,Libya,Libya,1,0,African Nations Championship,Radès,Tunisia,2015,5,10,1,-1,1,1,winner,loser,1782,7,1,0,0.3671551,0.873588187
22/10/2015,22,Libya,Libya,Morocco,Morocco,0,4,African Nations Championship,Radès,Tunisia,2015,5,10,-4,4,4,4,loser,winner,1783,7,0,0,0.71318357,0.158780255
25/10/2015,25,Tunisia,Tunisia,Morocco,Morocco,2,3,African Nations Championship,Radès,Tunisia,2015,5,10,-1,1,1,5,loser,winner,1784,7,1,0,0.6982114,0.467745393
28/07/2005,28,Kuwait,Kuwait,UAE,UAE,1,1,Friendly,Geneva,Switzerland,2005,5,7,0,0,0,2,draw,draw,1240,6,0,0,0.25583305,0.860420579
13/11/2015,13,Mauritania,Mauritania,Tunisia,Tunisia,1,2,FIFA World Cup qualification,Nouakchott,Mauritania,2015,5,11,-1,1,1,3,loser,winner,1786,7,1,1,0.0752624,0.680839087
17/11/2015,17,Tunisia,Tunisia,Mauritania,Mauritania,2,1,FIFA World Cup qualification,Radès,Tunisia,2015,5,11,1,-1,1,3,winner,loser,1787,7,1,1,0.64208637,0.858290967
24/02/2012,24,UAE,UAE,Palestine,Palestine,3,0,Friendly,Abu Dhabi,United Arab Emirates,2012,2,2,3,-3,3,3,winner,loser,1573,7,0,0,0.01357912,0.690894071
29/02/2012,29,UAE,UAE,Lebanon,Lebanon,4,2,FIFA World Cup qualification,Abu Dhabi,United Arab Emirates,2012,2,2,2,-2,2,6,winner,loser,1574,7,0,1,0.12375969,0.366307264
27/11/2015,27,Djibouti,Djibouti,Sudan,Sudan,0,4,CECAFA Cup,Bahir Dar,Ethiopia,2015,5,11,-4,4,4,4,loser,winner,1790,7,0,1,0.16775755,0.865400411
11/09/2012,11,UAE,UAE,Kuwait,Kuwait,3,0,Friendly,Dubai,United Arab Emirates,2012,2,9,3,-3,3,3,winner,loser,1607,7,0,0,0.61501163,0.739880253
27/01/2016,27,Egypt,Egypt,Jordan,Jordan,0,1,Friendly,Aswan,Egypt,2016,6,1,-1,1,1,1,loser,winner,1792,7,1,1,0.40867448,0.757681639
29/01/2016,29,Egypt,Egypt,Libya,Libya,2,0,Friendly,Aswan,Egypt,2016,6,1,2,-2,2,2,winner,loser,1793,7,1,0,0.96894922,0.750167824
05/02/2016,5,Bahrain,Bahrain,Lebanon,Lebanon,2,0,Friendly,Riffa,Bahrain,2016,6,2,2,-2,2,2,winner,loser,1794,7,0,1,0.84122798,0.315513447
18/03/2016,18,Iraq,Iraq,Syria,Syria,0,1,Friendly,Teheran,Iran,2016,6,3,-1,1,1,1,loser,winner,1795,7,0,0,0.42332908,0.797164237
24/03/2016,24,Bahrain,Bahrain,Yemen,Yemen,3,0,FIFA World Cup qualification,Riffa,Bahrain,2016,6,3,3,-3,3,3,winner,loser,1796,7,0,1,0.59696509,0.859745979
16/10/2012,16,UAE,UAE,Bahrain,Bahrain,6,2,Friendly,Dubai,United Arab Emirates,2012,2,10,4,-4,4,8,winner,loser,1613,7,0,0,0.40528976,0.64862861
25/12/2012,25,UAE,UAE,Yemen,Yemen,2,0,Friendly,Doha,Qatar,2012,2,12,2,-2,2,2,winner,loser,1638,7,0,1,0.55297305,0.565110144
03/06/2016,3,Djibouti,Djibouti,Tunisia,Tunisia,0,3,African Cup of Nations qualification,Djibouti,Djibouti,2016,6,6,-3,3,3,3,loser,winner,1799,7,0,1,0.50178302,0.605945033
03/06/2016,3,Libya,Libya,Morocco,Morocco,1,1,African Cup of Nations qualification,Radès,Tunisia,2016,6,6,0,0,0,2,draw,draw,1800,7,0,0,0.32186581,0.050229686
29/12/2012,29,UAE,UAE,Yemen,Yemen,3,1,Friendly,Doha,Qatar,2012,2,12,2,-2,2,4,winner,loser,1640,7,0,1,0.02641215,0.282176717
11/01/2013,11,UAE,UAE,Oman,Oman,2,0,Gulf Cup,Isa Town,Bahrain,2013,3,1,2,-2,2,2,winner,loser,1651,7,0,1,0.04684324,0.467160189
08/08/2016,8,Qatar,Qatar,Iraq,Iraq,2,1,Friendly,Doha,Qatar,2016,6,8,1,-1,1,3,winner,loser,1803,7,1,0,0.82842066,0.103743398
18/08/2016,18,Jordan,Jordan,Qatar,Qatar,2,3,Friendly,Lucerne,Switzerland,2016,6,8,-1,1,1,5,loser,winner,1804,7,1,1,0.73730358,0.733418234
31/08/2016,31,Lebanon,Lebanon,Jordan,Jordan,1,1,Friendly,Beirut,Lebanon,2016,6,8,0,0,0,2,draw,draw,1805,7,1,1,0.72987367,0.923101587
04/09/2016,4,Bahrain,Bahrain,Jordan,Jordan,0,0,Friendly,Isa Town,Bahrain,2016,6,9,0,0,0,0,draw,draw,1806,7,0,1,0.14958045,0.83437423
30/07/2005,30,Egypt,Egypt,UAE,UAE,0,0,Friendly,Geneva,Switzerland,2005,5,7,0,0,0,0,draw,draw,1241,6,1,0,0.81903772,0.881636621
07/10/2016,7,Oman,Oman,Jordan,Jordan,1,1,Friendly,Muscat,Oman,2016,6,10,0,0,0,2,draw,draw,1808,7,1,1,0.34889384,0.46154822
11/10/2016,11,Oman,Oman,Bahrain,Bahrain,2,2,Friendly,Muscat,Oman,2016,6,10,0,0,0,4,draw,draw,1809,7,1,0,0.05075261,0.750728529
11/10/2016,11,Qatar,Qatar,Syria,Syria,1,0,FIFA World Cup qualification,Doha,Qatar,2016,6,10,1,-1,1,1,winner,loser,1810,7,1,0,0.79994856,0.583703755
15/01/2013,15,UAE,UAE,Kuwait,Kuwait,1,0,Gulf Cup,Riffa,Bahrain,2013,3,1,1,-1,1,1,winner,loser,1655,7,0,0,0.21891163,0.263687438
06/11/2016,6,Jordan,Jordan,Iraq,Iraq,0,0,Friendly,Amman,Jordan,2016,6,11,0,0,0,0,draw,draw,1812,7,1,0,0.8596345,0.499847774
18/01/2013,18,UAE,UAE,Iraq,Iraq,2,1,Gulf Cup,Riffa,Bahrain,2013,3,1,1,-1,1,3,winner,loser,1657,7,0,0,0.25839965,0.696551064
10/11/2016,10,Lebanon,Lebanon,Palestine,Palestine,1,1,Friendly,Beirut,Lebanon,2016,6,11,0,0,0,2,draw,draw,1814,7,1,0,0.32581885,0.442797846
11/11/2016,11,Libya,Libya,Tunisia,Tunisia,0,1,FIFA World Cup qualification,Algiers,Algeria,2016,6,11,-1,1,1,1,loser,winner,1815,7,0,1,0.34886673,0.810459784
15/11/2016,15,Jordan,Jordan,Lebanon,Lebanon,0,0,Friendly,Amman,Jordan,2016,6,11,0,0,0,0,draw,draw,1816,7,1,1,0.72852214,0.122687685
15/11/2016,15,Tunisia,Tunisia,Mauritania,Mauritania,0,0,Friendly,Gabès,Tunisia,2016,6,11,0,0,0,0,draw,draw,1817,7,1,1,0.94262425,0.29632543
06/11/2014,6,UAE,UAE,Lebanon,Lebanon,3,2,Friendly,al-Hasa,Saudi Arabia,2014,4,11,1,-1,1,5,winner,loser,1723,7,0,1,0.49579483,0.182696168
07/01/2017,7,Algeria,Algeria,Mauritania,Mauritania,3,1,Friendly,Blida,Algeria,2017,7,1,2,-2,2,4,winner,loser,1819,7,1,1,0.02368743,0.518318665
08/01/2017,8,Egypt,Egypt,Tunisia,Tunisia,1,0,Friendly,Cairo,Egypt,2017,7,1,1,-1,1,1,winner,loser,1820,7,1,1,0.13734167,0.918792614
10/01/2017,10,Algeria,Algeria,Mauritania,Mauritania,6,0,Friendly,Sidi Moussa,Algeria,2017,7,1,6,-6,6,6,winner,loser,1821,7,1,1,0.11693945,0.520669854
19/01/2017,19,Algeria,Algeria,Tunisia,Tunisia,1,2,African Cup of Nations,Franceville,Gabon,2017,7,1,-1,1,1,3,loser,winner,1822,7,1,1,0.82270425,0.729219566
29/01/2017,29,Egypt,Egypt,Morocco,Morocco,1,0,African Cup of Nations,Port-Gentil,Gabon,2017,7,1,1,-1,1,1,winner,loser,1823,7,1,0,0.6189024,0.994060969
16/11/2005,16,Syria,Syria,UAE,UAE,0,3,Friendly,Damascus,Syria,2005,5,11,-3,3,3,3,loser,winner,1249,6,0,0,0.6817956,0.31604117
22/03/2017,22,Yemen,Yemen,Palestine,Palestine,0,1,Friendly,al-Wakrah,Qatar,2017,7,3,-1,1,1,1,loser,winner,1825,7,1,0,0.94224208,0.424709635
28/03/2017,28,Morocco,Morocco,Tunisia,Tunisia,1,0,Friendly,Marrakech,Morocco,2017,7,3,1,-1,1,1,winner,loser,1826,7,0,1,0.90792886,0.762829626
14/11/2014,14,UAE,UAE,Oman,Oman,0,0,Gulf Cup,Riyadh,Saudi Arabia,2014,4,11,0,0,0,0,draw,draw,1728,7,0,1,0.77677926,0.732654803
17/11/2014,17,UAE,UAE,Kuwait,Kuwait,2,2,Gulf Cup,Riyadh,Saudi Arabia,2014,4,11,0,0,0,4,draw,draw,1732,7,0,0,0.99232556,0.794687912
16/08/2006,16,Jordan,Jordan,UAE,UAE,1,2,AFC Asian Cup qualification,Amman,Jordan,2006,6,8,-1,1,1,3,loser,winner,1291,6,1,0,0.82407312,0.484059268
20/11/2014,20,UAE,UAE,Iraq,Iraq,2,0,Gulf Cup,Riyadh,Saudi Arabia,2014,4,11,2,-2,2,2,winner,loser,1737,7,0,0,0.37725307,0.290112919
13/05/2017,13,Egypt,Egypt,Libya,Libya,1,0,Friendly,Cairo,Egypt,2017,7,5,1,-1,1,1,winner,loser,1831,7,1,0,0.01351656,0.111124157
01/06/2017,1,Iraq,Iraq,Jordan,Jordan,1,0,Friendly,Basra,Iraq,2017,7,6,1,-1,1,1,winner,loser,1832,7,0,1,0.96660958,0.897471568
02/06/2017,2,Oman,Oman,Syria,Syria,1,1,Friendly,Muscat,Oman,2017,7,6,0,0,0,2,draw,draw,1833,7,1,0,0.85636046,0.517201407
05/06/2017,5,Egypt,Egypt,Libya,Libya,1,0,Friendly,New Cairo,Egypt,2017,7,6,1,-1,1,1,winner,loser,1834,7,1,0,0.08484652,0.143739881
06/06/2017,6,Bahrain,Bahrain,Palestine,Palestine,0,2,Friendly,Riffa,Bahrain,2017,7,6,-2,2,2,2,loser,winner,1835,7,0,0,0.34875461,0.508834705
13/06/2017,13,Palestine,Palestine,Oman,Oman,2,1,AFC Asian Cup qualification,al-Ram,Palestine,2017,7,6,1,-1,1,3,winner,loser,1836,7,0,1,0.90528471,0.073571382
12/08/2017,12,Algeria,Algeria,Libya,Libya,1,2,African Nations Championship,Constantine,Algeria,2017,7,8,-1,1,1,3,loser,winner,1837,7,1,0,0.8436832,0.508357577
13/08/2017,13,Egypt,Egypt,Morocco,Morocco,1,1,African Nations Championship,Alexandria,Egypt,2017,7,8,0,0,0,2,draw,draw,1838,7,1,0,0.57399699,0.691757452
18/08/2017,18,Libya,Libya,Algeria,Algeria,1,1,African Nations Championship,Sfax,Tunisia,2017,7,8,0,0,0,2,draw,draw,1839,7,0,1,0.69709283,0.589094925
18/08/2017,18,Morocco,Morocco,Egypt,Egypt,3,1,African Nations Championship,Rabat,Morocco,2017,7,8,2,-2,2,4,winner,loser,1840,7,0,1,0.70700254,0.379479725
26/08/2017,26,Iraq,Iraq,Syria,Syria,1,1,Friendly,Paya Rumput,Malaysia,2017,7,8,0,0,0,2,draw,draw,1841,7,0,0,0.6431912,0.178628215
29/08/2017,29,Bahrain,Bahrain,Jordan,Jordan,0,0,Friendly,Isa Town,Bahrain,2017,7,8,0,0,0,0,draw,draw,1842,7,0,1,0.10742264,0.771995255
25/11/2014,25,UAE,UAE,Oman,Oman,1,0,Gulf Cup,Riyadh,Saudi Arabia,2014,4,11,1,-1,1,1,winner,loser,1740,7,0,1,0.35432609,0.246908074
31/08/2017,31,Syria,Syria,Qatar,Qatar,3,1,FIFA World Cup qualification,Paya Rumput,Malaysia,2017,7,8,2,-2,2,4,winner,loser,1844,7,0,1,0.62096672,0.690527427
11/10/2006,11,Oman,Oman,UAE,UAE,2,1,AFC Asian Cup qualification,Muscat,Oman,2006,6,10,1,-1,1,3,winner,loser,1302,6,1,0,0.56446424,0.603916096
06/10/2017,6,Mauritania,Mauritania,Comoros,Comoros,0,1,Friendly,La Marsa,Tunisia,2017,7,10,-1,1,1,1,loser,winner,1846,7,1,1,0.01209619,0.993306116
11/11/2017,11,Tunisia,Tunisia,Libya,Libya,0,0,FIFA World Cup qualification,Radès,Tunisia,2017,7,11,0,0,0,0,draw,draw,1847,7,1,0,0.0482982,0.768830892
13/11/2017,13,Iraq,Iraq,Syria,Syria,1,1,Friendly,Karbala,Iraq,2017,7,11,0,0,0,2,draw,draw,1848,7,0,0,0.09340298,0.266183628
18/12/2017,18,Bahrain,Bahrain,Kuwait,Kuwait,0,0,Friendly,Riffa,Bahrain,2017,7,12,0,0,0,0,draw,draw,1849,7,0,0,0.02879655,0.051225943
16/07/2007,16,Qatar,Qatar,UAE,UAE,1,2,AFC Asian Cup,Ho Chi Minh City,Vietnam,2007,7,7,-1,1,1,3,loser,winner,1353,6,1,0,0.01745002,0.574842761
19/03/2008,19,Oman,Oman,UAE,UAE,1,1,Friendly,Muscat,Oman,2008,8,3,0,0,0,2,draw,draw,1380,6,1,0,0.18719938,0.236715368
23/12/2017,23,Bahrain,Bahrain,Iraq,Iraq,1,1,Gulf Cup,Kuwait City,Kuwait,2017,7,12,0,0,0,2,draw,draw,1852,7,0,0,0.27899787,0.439781675
23/12/2017,23,Qatar,Qatar,Yemen,Yemen,4,0,Gulf Cup,Kuwait City,Kuwait,2017,7,12,4,-4,4,4,winner,loser,1853,7,1,1,0.88401058,0.681360822
25/12/2017,25,Jordan,Jordan,Libya,Libya,1,1,Friendly,Amman,Jordan,2017,7,12,0,0,0,2,draw,draw,1854,7,1,0,0.09812253,0.659407335
25/12/2017,25,Kuwait,Kuwait,Oman,Oman,0,1,Gulf Cup,Kuwait City,Kuwait,2017,7,12,-1,1,1,1,loser,winner,1855,7,0,1,0.41709466,0.791728883
30/12/2014,30,UAE,UAE,Jordan,Jordan,1,0,Friendly,Robina,Australia,2014,4,12,1,-1,1,1,winner,loser,1744,7,0,1,0.0161053,0.785659928
26/12/2017,26,Iraq,Iraq,Qatar,Qatar,2,1,Gulf Cup,Kuwait City,Kuwait,2017,7,12,1,-1,1,3,winner,loser,1857,7,0,1,0.58810953,0.629683806
26/12/2017,26,Yemen,Yemen,Bahrain,Bahrain,0,1,Gulf Cup,Kuwait City,Kuwait,2017,7,12,-1,1,1,1,loser,winner,1858,7,1,0,0.51349529,0.615890606
26/03/2008,26,Syria,Syria,UAE,UAE,1,1,FIFA World Cup qualification,Damascus,Syria,2008,8,3,0,0,0,2,draw,draw,1383,6,0,0,0.93509464,0.454618011
11/01/2015,11,UAE,UAE,Qatar,Qatar,4,1,AFC Asian Cup,Canberra,Australia,2015,5,1,3,-3,3,5,winner,loser,1748,7,0,1,0.07102807,0.736953517
29/12/2017,29,Iraq,Iraq,Yemen,Yemen,3,0,Gulf Cup,Kuwait City,Kuwait,2017,7,12,3,-3,3,3,winner,loser,1861,7,0,1,0.72617462,0.625610294
29/12/2017,29,Qatar,Qatar,Bahrain,Bahrain,1,1,Gulf Cup,Kuwait City,Kuwait,2017,7,12,0,0,0,2,draw,draw,1862,7,1,0,0.22715649,0.655942514
14/06/2008,14,Kuwait,Kuwait,UAE,UAE,2,3,FIFA World Cup qualification,Kuwait City,Kuwait,2008,8,6,-1,1,1,5,loser,winner,1398,6,0,0,0.34220146,0.928851504
02/01/2018,2,Oman,Oman,Bahrain,Bahrain,1,0,Gulf Cup,Kuwait City,Kuwait,2018,8,1,1,-1,1,1,winner,loser,1864,7,1,0,0.047204,0.276871439
20/08/2008,20,Algeria,Algeria,UAE,UAE,1,0,Friendly,Le Touquet-Paris-Plage,France,2008,8,8,1,-1,1,1,winner,loser,1405,6,1,0,0.21729282,0.755554411
13/01/2018,13,Morocco,Morocco,Mauritania,Mauritania,4,0,African Nations Championship,Casablanca,Morocco,2018,8,1,4,-4,4,4,winner,loser,1866,7,0,1,0.82096512,0.310044074
17/01/2018,17,Sudan,Sudan,Mauritania,Mauritania,1,0,African Nations Championship,Casablanca,Morocco,2018,8,1,1,-1,1,1,winner,loser,1867,7,1,1,0.39205392,0.854097433
21/01/2018,21,Sudan,Sudan,Morocco,Morocco,0,0,African Nations Championship,Casablanca,Morocco,2018,8,1,0,0,0,0,draw,draw,1868,7,1,0,0.2404924,0.69982408
31/01/2018,31,Morocco,Morocco,Libya,Libya,3,1,African Nations Championship,Casablanca,Morocco,2018,8,1,2,-2,2,4,winner,loser,1869,7,0,0,0.83695943,0.655827749
03/02/2018,3,Libya,Libya,Sudan,Sudan,1,1,African Nations Championship,Marrakech,Morocco,2018,8,2,0,0,0,2,draw,draw,1870,7,0,1,0.65547621,0.554042633
08/01/2009,8,Qatar,Qatar,UAE,UAE,0,0,Gulf Cup,Muscat,Oman,2009,9,1,0,0,0,0,draw,draw,1429,6,1,0,0.62165425,0.188304602
21/03/2018,21,Iraq,Iraq,Qatar,Qatar,2,3,Friendly,Basra,Iraq,2018,8,3,-1,1,1,5,loser,winner,1872,7,0,1,0.21586695,0.682356722
21/03/2018,21,Jordan,Jordan,Kuwait,Kuwait,1,0,Friendly,Amman,Jordan,2018,8,3,1,-1,1,1,winner,loser,1873,7,1,0,0.87239365,0.807333791
22/03/2018,22,Bahrain,Bahrain,Palestine,Palestine,0,0,Friendly,Riffa,Bahrain,2018,8,3,0,0,0,0,draw,draw,1874,7,0,0,0.65817089,0.593569005
24/03/2018,24,Qatar,Qatar,Syria,Syria,2,2,Friendly,Basra,Iraq,2018,8,3,0,0,0,4,draw,draw,1875,7,1,0,0.89018475,0.173296172
27/03/2018,27,Iraq,Iraq,Syria,Syria,1,1,Friendly,Basra,Iraq,2018,8,3,0,0,0,2,draw,draw,1876,7,0,0,0.87636563,0.132959159
27/03/2018,27,Oman,Oman,Palestine,Palestine,1,0,AFC Asian Cup qualification,Muscat,Oman,2018,8,3,1,-1,1,1,winner,loser,1877,7,1,0,0.26058803,0.390611988
08/05/2018,8,Iraq,Iraq,Palestine,Palestine,0,0,Friendly,Basra,Iraq,2018,8,5,0,0,0,0,draw,draw,1878,7,0,0,0.79125836,0.063028608
16/12/2009,16,Kuwait,Kuwait,UAE,UAE,0,0,Friendly,Kuwait City,Kuwait,2009,9,12,0,0,0,0,draw,draw,1468,6,0,0,0.61299367,0.985531584
11/05/2018,11,Kuwait,Kuwait,Palestine,Palestine,2,0,Friendly,Kuwait City,Kuwait,2018,8,5,2,-2,2,2,winner,loser,1880,7,0,0,0.37732535,0.864457905
25/05/2018,25,Kuwait,Kuwait,Egypt,Egypt,1,1,Friendly,Kuwait,Kuwait,2018,8,5,0,0,0,2,draw,draw,1881,7,0,1,0.06848986,0.421437471
24/03/2016,24,UAE,UAE,Palestine,Palestine,2,0,FIFA World Cup qualification,Abu Dhabi,United Arab Emirates,2016,6,3,2,-2,2,2,winner,loser,1797,7,0,0,0.27433187,0.222675134
04/08/2018,4,Palestine,Palestine,Iraq,Iraq,0,3,Friendly,Al Ram,Palestine,2018,8,8,-3,3,3,3,loser,winner,1883,7,0,0,0.09261185,0.838030543
06/09/2018,6,Jordan,Jordan,Lebanon,Lebanon,0,1,Friendly,Amman,Jordan,2018,8,9,-1,1,1,1,loser,winner,1884,7,1,1,0.05051204,0.132712526
09/09/2018,9,Lebanon,Lebanon,Oman,Oman,0,0,Friendly,Amman,Jordan,2018,8,9,0,0,0,0,draw,draw,1885,7,1,1,0.97699061,0.930441503
10/09/2018,10,Kuwait,Kuwait,Iraq,Iraq,2,2,Friendly,Al Farwaniyah,Kuwait,2018,8,9,0,0,0,4,draw,draw,1886,7,0,0,0.40716034,0.334214681
11/09/2018,11,Jordan,Jordan,Oman,Oman,0,0,Friendly,Amman,Jordan,2018,8,9,0,0,0,0,draw,draw,1887,7,1,1,0.60127217,0.408589638
11/09/2018,11,Qatar,Qatar,Palestine,Palestine,3,0,Friendly,Doha,Qatar,2018,8,9,3,-3,3,3,winner,loser,1888,7,1,0,0.4612613,0.204429654
11/10/2018,11,Bahrain,Bahrain,Syria,Syria,0,1,Friendly,East Riffa,Bahrain,2018,8,10,-1,1,1,1,loser,winner,1889,7,0,0,0.6577716,0.790981606
11/10/2018,11,Kuwait,Kuwait,Lebanon,Lebanon,1,0,Friendly,Kuwait City,Kuwait,2018,8,10,1,-1,1,1,winner,loser,1890,7,0,1,0.26074826,0.210310826
05/06/2010,5,Algeria,Algeria,UAE,UAE,1,0,Friendly,Fürth,Germany,2010,0,6,1,-1,1,1,winner,loser,1477,7,1,0,0.12791901,0.741762046
16/11/2018,16,Oman,Oman,Syria,Syria,1,1,Friendly,Muscat,Oman,2018,8,11,0,0,0,2,draw,draw,1892,7,1,0,0.71890657,0.370454902
03/06/2016,3,UAE,UAE,Jordan,Jordan,1,3,King's Cup,Bangkok,Thailand,2016,6,6,-2,2,2,4,loser,winner,1801,7,0,1,0.0150681,0.968701508
16/11/2018,16,Egypt,Egypt,Tunisia,Tunisia,3,2,African Cup of Nations qualification,Alexandria,Egypt,2018,8,11,1,-1,1,5,winner,loser,1894,7,1,1,0.04265164,0.035880524
19/11/2018,19,Oman,Oman,Bahrain,Bahrain,2,1,Friendly,Muscat,Oman,2018,8,11,1,-1,1,3,winner,loser,1895,7,1,0,0.25281968,0.411818971
23/11/2010,23,Iraq,Iraq,UAE,UAE,0,0,Gulf Cup,Aden,Yemen,2010,0,11,0,0,0,0,draw,draw,1502,7,0,0,0.85682577,0.751022055
20/11/2018,20,Kuwait,Kuwait,Syria,Syria,1,2,Friendly,Al Farwaniyah,Kuwait,2018,8,11,-1,1,1,3,loser,winner,1897,7,0,0,0.31709449,0.465543012
20/11/2018,20,Tunisia,Tunisia,Morocco,Morocco,0,1,Friendly,Radès,Tunisia,2018,8,11,-1,1,1,1,loser,winner,1898,7,1,0,0.00969269,0.061695117
05/06/2016,5,UAE,UAE,Syria,Syria,0,1,King's Cup,Bangkok,Thailand,2016,6,6,-1,1,1,1,loser,winner,1802,7,0,0,0.72361344,0.032983093
23/12/2018,23,Qatar,Qatar,Jordan,Jordan,2,0,Friendly,Doha,Qatar,2018,8,12,2,-2,2,2,winner,loser,1900,7,1,1,0.45174405,0.659875015
27/12/2018,27,Bahrain,Bahrain,Lebanon,Lebanon,1,0,Friendly,East Riffa,Bahrain,2018,8,12,1,-1,1,1,winner,loser,1901,7,0,1,0.92989895,0.423086848
27/12/2018,27,Qatar,Qatar,Algeria,Algeria,0,1,Friendly,Doha,Qatar,2018,8,12,-1,1,1,1,loser,winner,1902,7,1,1,0.95769466,0.343721607
28/12/2018,28,Iraq,Iraq,Palestine,Palestine,1,0,Friendly,Doha,Qatar,2018,8,12,1,-1,1,1,winner,loser,1903,7,0,0,0.61419977,0.429688469
09/11/2016,9,UAE,UAE,Bahrain,Bahrain,2,0,Friendly,al-Ain,United Arab Emirates,2016,6,11,2,-2,2,2,winner,loser,1813,7,0,0,0.66877224,0.581024621
30/12/2018,30,Yemen,Yemen,Syria,Syria,0,1,Friendly,Abu Dhabi,United Arab Emirates,2018,8,12,-1,1,1,1,loser,winner,1905,7,1,0,0.98074461,0.273031599
15/11/2016,15,UAE,UAE,Iraq,Iraq,2,0,FIFA World Cup qualification,Abu Dhabi,United Arab Emirates,2016,6,11,2,-2,2,2,winner,loser,1818,7,0,0,0.03267474,0.184117886
06/01/2019,6,Syria,Syria,Palestine,Palestine,0,0,AFC Asian Cup,Sharjah,United Arab Emirates,2019,9,1,0,0,0,0,draw,draw,1907,7,0,0,0.86641087,0.375489833
09/01/2019,9,Qatar,Qatar,Lebanon,Lebanon,2,0,AFC Asian Cup,Al Ain,United Arab Emirates,2019,9,1,2,-2,2,2,winner,loser,1908,7,1,1,0.56995176,0.857902121
10/01/2019,10,Jordan,Jordan,Syria,Syria,2,0,AFC Asian Cup,Al Ain,United Arab Emirates,2019,9,1,2,-2,2,2,winner,loser,1909,7,1,0,0.30524676,0.908729864
12/01/2019,12,Yemen,Yemen,Iraq,Iraq,0,3,AFC Asian Cup,Sharjah,United Arab Emirates,2019,9,1,-3,3,3,3,loser,winner,1910,7,1,0,0.66683686,0.645410621
06/09/2011,6,Lebanon,Lebanon,UAE,UAE,3,1,FIFA World Cup qualification,Beirut,Lebanon,2011,1,9,2,-2,2,4,winner,loser,1558,7,1,0,0.38237621,0.156579171
15/01/2019,15,Palestine,Palestine,Jordan,Jordan,0,0,AFC Asian Cup,Abu Dhabi,United Arab Emirates,2019,9,1,0,0,0,0,draw,draw,1912,7,0,1,0.52746986,0.235592703
15/11/2011,15,Kuwait,Kuwait,UAE,UAE,2,1,FIFA World Cup qualification,Kuwait City,Kuwait,2011,1,11,1,-1,1,3,winner,loser,1566,7,0,0,0.03977108,0.230415746
22/01/2019,22,Qatar,Qatar,Iraq,Iraq,1,0,AFC Asian Cup,Abu Dhabi,United Arab Emirates,2019,9,1,1,-1,1,1,winner,loser,1914,7,1,0,0.87773293,0.260871176
05/01/2013,5,Qatar,Qatar,UAE,UAE,1,3,Gulf Cup,Riffa,Bahrain,2013,3,1,-2,2,2,4,loser,winner,1643,7,1,0,0.53674192,0.456619333
08/01/2013,8,Bahrain,Bahrain,UAE,UAE,1,2,Gulf Cup,Riffa,Bahrain,2013,3,1,-1,1,1,3,loser,winner,1646,7,0,0,0.0314041,0.503246314
26/03/2019,26,Algeria,Algeria,Tunisia,Tunisia,1,0,Friendly,Blida,Algeria,2019,9,3,1,-1,1,1,winner,loser,1917,7,1,1,0.85048056,0.860563471
20/11/2018,20,UAE,UAE,Yemen,Yemen,2,0,Friendly,Dubai,United Arab Emirates,2018,8,11,2,-2,2,2,winner,loser,1899,7,0,1,0.07315991,0.20632684
07/06/2019,7,Tunisia,Tunisia,Iraq,Iraq,2,0,Friendly,Radès,Tunisia,2019,9,6,2,-2,2,2,winner,loser,1919,7,1,0,0.04407756,0.097512416
02/07/2019,2,Mauritania,Mauritania,Tunisia,Tunisia,0,0,African Cup of Nations,Suez,Egypt,2019,9,7,0,0,0,0,draw,draw,1920,7,1,1,0.19189907,0.358094677
05/09/2019,5,Bahrain,Bahrain,Iraq,Iraq,1,1,FIFA World Cup qualification,Riffa,Bahrain,2019,9,9,0,0,0,2,draw,draw,1921,7,0,0,0.03825519,0.803287348
06/09/2019,6,Tunisia,Tunisia,Mauritania,Mauritania,1,0,Friendly,Radès,Tunisia,2019,9,9,1,-1,1,1,winner,loser,1922,7,1,1,0.52258789,0.329097932
10/09/2019,10,Oman,Oman,Lebanon,Lebanon,1,0,Friendly,Muscat,Oman,2019,9,9,1,-1,1,1,winner,loser,1923,7,1,1,0.40266042,0.386460317
15/01/2015,15,Bahrain,Bahrain,UAE,UAE,1,2,AFC Asian Cup,Canberra,Australia,2015,5,1,-1,1,1,3,loser,winner,1750,7,0,0,0.49894585,0.955529037
21/09/2019,21,Algeria,Algeria,Morocco,Morocco,0,0,African Nations Championship qualification,Blida,Algeria,2019,9,9,0,0,0,0,draw,draw,1925,7,1,0,0.74292003,0.97662957
21/09/2019,21,Tunisia,Tunisia,Libya,Libya,1,0,African Nations Championship qualification,Radès,Tunisia,2019,9,9,1,-1,1,1,winner,loser,1926,7,1,0,0.06446467,0.700458774
10/10/2019,10,Jordan,Jordan,Kuwait,Kuwait,0,0,FIFA World Cup qualification,Amman,Jordan,2019,9,10,0,0,0,0,draw,draw,1927,7,1,0,0.01956598,0.870318049
11/10/2019,11,Morocco,Morocco,Libya,Libya,1,1,Friendly,Morocco,Morocco,2019,9,10,0,0,0,2,draw,draw,1928,7,0,0,0.24309727,0.187613451
15/10/2019,15,Mauritania,Mauritania,Libya,Libya,0,0,Friendly,Nouakchott,Mauritania,2019,9,10,0,0,0,0,draw,draw,1929,7,1,0,0.57054418,0.417891806
30/01/2015,30,Iraq,Iraq,UAE,UAE,2,3,AFC Asian Cup,Newcastle,Australia,2015,5,1,-1,1,1,5,loser,winner,1755,7,0,0,0.8686083,0.103671746
15/10/2019,15,Qatar,Qatar,Oman,Oman,2,1,FIFA World Cup qualification,Al Wakrah,Qatar,2019,9,10,1,-1,1,3,winner,loser,1931,7,1,1,0.9072192,0.878306173
19/10/2019,19,Morocco,Morocco,Algeria,Algeria,3,0,African Nations Championship qualification,Berkane,Morocco,2019,9,10,3,-3,3,3,winner,loser,1932,7,0,1,0.04216882,0.962294122
20/10/2019,20,Libya,Libya,Tunisia,Tunisia,1,2,African Nations Championship qualification,Libya,Libya,2019,9,10,-1,1,1,3,loser,winner,1933,7,0,1,0.73008188,0.53560745
14/11/2019,14,Yemen,Yemen,Palestine,Palestine,1,0,FIFA World Cup qualification,Muharraq,Bahrain,2019,9,11,1,-1,1,1,winner,loser,1934,7,1,0,0.58890645,0.299268996
15/11/2019,15,Morocco,Morocco,Mauritania,Mauritania,0,0,African Cup of Nations qualification,Rabat,Morocco,2019,9,11,0,0,0,0,draw,draw,1935,7,0,1,0.29281985,0.869700471
15/11/2019,15,Tunisia,Tunisia,Libya,Libya,4,1,African Cup of Nations qualification,Radès,Tunisia,2019,9,11,3,-3,3,5,winner,loser,1936,7,1,0,0.83532023,0.63933909
18/11/2019,18,Comoros,Comoros,Egypt,Egypt,0,0,African Cup of Nations qualification,Moroni,Comoros,2019,9,11,0,0,0,0,draw,draw,1937,7,1,1,0.89261372,0.390160772
19/11/2019,19,Iraq,Iraq,Bahrain,Bahrain,0,0,FIFA World Cup qualification,Amman,Jordan,2019,9,11,0,0,0,0,draw,draw,1938,7,0,0,0.83450737,0.013065981
26/11/2019,26,Qatar,Qatar,Iraq,Iraq,1,2,Gulf Cup,Doha,Qatar,2019,9,11,-1,1,1,3,loser,winner,1939,7,1,0,0.34793668,0.433465222
28/12/2018,28,UAE,UAE,Kuwait,Kuwait,0,2,Friendly,Dubai,United Arab Emirates,2018,8,12,-2,2,2,2,loser,winner,1904,7,0,0,0.03963755,0.997326341
27/11/2019,27,Oman,Oman,Bahrain,Bahrain,0,0,Gulf Cup,Doha,Qatar,2019,9,11,0,0,0,0,draw,draw,1941,7,1,0,0.14328177,0.131570344
05/01/2019,5,UAE,UAE,Bahrain,Bahrain,1,1,AFC Asian Cup,Abu Dhabi,United Arab Emirates,2019,9,1,0,0,0,2,draw,draw,1906,7,0,0,0.05030376,0.985747883
08/09/2015,8,Palestine,Palestine,UAE,UAE,0,0,FIFA World Cup qualification,al-Ramm,Palestine,2015,5,9,0,0,0,0,draw,draw,1774,7,0,0,0.10926115,0.001406223
29/11/2019,29,Qatar,Qatar,Yemen,Yemen,6,0,Gulf Cup,Doha,Qatar,2019,9,11,6,-6,6,6,winner,loser,1944,7,1,1,0.07252121,0.831621215
30/11/2019,30,Kuwait,Kuwait,Oman,Oman,1,2,Gulf Cup,Doha,Qatar,2019,9,11,-1,1,1,3,loser,winner,1945,7,0,1,0.59202551,0.435085522
05/09/2017,5,Iraq,Iraq,UAE,UAE,1,0,FIFA World Cup qualification,Amman,Jordan,2017,7,9,1,-1,1,1,winner,loser,1845,7,0,0,0.19147555,0.343164247
22/12/2017,22,Oman,Oman,UAE,UAE,0,1,Gulf Cup,Kuwait City,Kuwait,2017,7,12,-1,1,1,1,loser,winner,1851,7,1,0,0.00319548,0.888280201
02/12/2019,2,Yemen,Yemen,Iraq,Iraq,0,0,Gulf Cup,Doha,Qatar,2019,9,12,0,0,0,0,draw,draw,1948,7,1,0,0.1604705,0.927299886
02/12/2019,2,Kuwait,Kuwait,Bahrain,Bahrain,2,4,Gulf Cup,Doha,Qatar,2019,9,12,-2,2,2,6,loser,winner,1949,7,0,0,0.17187166,0.594690744
28/12/2017,28,Kuwait,Kuwait,UAE,UAE,0,0,Gulf Cup,Kuwait City,Kuwait,2017,7,12,0,0,0,0,draw,draw,1859,7,0,0,0.71499262,0.12259289
05/12/2019,5,Iraq,Iraq,Bahrain,Bahrain,2,2,Gulf Cup,Doha,Qatar,2019,9,12,0,0,0,4,draw,draw,1951,7,0,0,0.87829342,0.568899713
02/01/2018,2,Iraq,Iraq,UAE,UAE,0,0,Gulf Cup,Kuwait City,Kuwait,2018,8,1,0,0,0,0,draw,draw,1863,7,0,0,0.14685869,0.120879492
05/01/2018,5,Oman,Oman,UAE,UAE,0,0,Gulf Cup,Kuwait City,Kuwait,2018,8,1,0,0,0,0,draw,draw,1865,7,1,0,0.92788683,0.015202501
09/10/2020,9,Tunisia,Tunisia,Sudan,Sudan,3,0,Friendly,Radès,Tunisia,2020,0,10,3,-3,3,3,winner,loser,1954,8,1,1,0.10351763,0.95611767
12/11/2020,12,Jordan,Jordan,Iraq,Iraq,0,0,Friendly,Dubai,United Arab Emirates,2020,0,11,0,0,0,0,draw,draw,1955,8,1,0,0.45429614,0.122674307
12/11/2020,12,Lebanon,Lebanon,Bahrain,Bahrain,1,3,Friendly,Dubai,United Arab Emirates,2020,0,11,-2,2,2,4,loser,winner,1956,8,1,0,0.78694159,0.971939527
16/11/2020,16,Jordan,Jordan,Syria,Syria,1,0,Friendly,Sharjah,United Arab Emirates,2020,0,11,1,-1,1,1,winner,loser,1957,8,1,0,0.28382388,0.738834101
26/03/2019,26,UAE,UAE,Syria,Syria,0,0,Friendly,Abu Dhabi,United Arab Emirates,2019,9,3,0,0,0,0,draw,draw,1918,7,0,0,0.9272259,0.393831783
26/11/2019,26,UAE,UAE,Yemen,Yemen,3,0,Gulf Cup,Doha,Qatar,2019,9,11,3,-3,3,3,winner,loser,1940,7,0,1,0.48367742,0.287613014
18/01/2021,18,Kuwait,Kuwait,Palestine,Palestine,0,1,Friendly,Kuwait City,Kuwait,2021,1,1,-1,1,1,1,loser,winner,1960,8,0,0,0.41205028,0.624362581
27/01/2021,27,Iraq,Iraq,Kuwait,Kuwait,2,1,Friendly,Basra,Iraq,2021,1,1,1,-1,1,3,winner,loser,1961,8,0,0,0.64929635,0.342316119
20/03/2021,20,Oman,Oman,Jordan,Jordan,0,0,Friendly,Dubai,United Arab Emirates,2021,1,3,0,0,0,0,draw,draw,1962,8,1,1,0.04977918,0.90899075
24/03/2021,24,Jordan,Jordan,Lebanon,Lebanon,1,0,Friendly,Dubai,United Arab Emirates,2021,1,3,1,-1,1,1,winner,loser,1963,8,1,1,0.50613208,0.137240439
25/03/2021,25,Bahrain,Bahrain,Syria,Syria,3,1,Friendly,Isa Town,Bahrain,2021,1,3,2,-2,2,4,winner,loser,1964,8,0,0,0.95078552,0.056228475
29/11/2019,29,UAE,UAE,Iraq,Iraq,0,2,Gulf Cup,Doha,Qatar,2019,9,11,-2,2,2,2,loser,winner,1943,7,0,0,0.27534362,0.872762201
25/03/2021,25,Libya,Libya,Tunisia,Tunisia,2,5,African Cup of Nations qualification,Benina,Libya,2021,1,3,-3,3,3,7,loser,winner,1966,8,0,1,0.38792691,0.34624737
26/03/2021,26,Mauritania,Mauritania,Morocco,Morocco,0,0,African Cup of Nations qualification,Nouakchott,Mauritania,2021,1,3,0,0,0,0,draw,draw,1967,8,1,0,0.21325805,0.149997363
29/03/2021,29,Kuwait,Kuwait,Lebanon,Lebanon,1,1,Friendly,Dubai,United Arab Emirates,2021,1,3,0,0,0,2,draw,draw,1968,8,0,1,0.46279286,0.55084106
29/03/2021,29,Egypt,Egypt,Comoros,Comoros,4,0,African Cup of Nations qualification,Cairo,Egypt,2021,1,3,4,-4,4,4,winner,loser,1969,8,1,1,0.94103894,0.12056777
30/03/2021,30,Bahrain,Bahrain,Jordan,Jordan,1,2,Friendly,Riffa,Bahrain,2021,1,3,-1,1,1,3,loser,winner,1970,8,0,1,0.48021383,0.283389849
16/11/2020,16,UAE,UAE,Bahrain,Bahrain,1,0,Friendly,Dubai,United Arab Emirates,2020,0,11,1,-1,1,1,winner,loser,1958,8,0,0,0.21254593,0.528156091
12/01/2021,12,UAE,UAE,Iraq,Iraq,0,0,Friendly,Dubai,United Arab Emirates,2021,1,1,0,0,0,0,draw,draw,1959,8,0,0,0.67241102,0.801832491
03/06/2021,3,Algeria,Algeria,Mauritania,Mauritania,4,1,Friendly,Blida,Algeria,2021,1,6,3,-3,3,5,winner,loser,1973,8,1,1,0.0383552,0.989660586
24/05/2021,24,UAE,UAE,Jordan,Jordan,5,1,Friendly,Dubai,United Arab Emirates,2021,1,5,4,-4,4,6,winner,loser,1972,8,0,1,0.71633741,0.548258509
07/06/2021,7,Oman,Oman,Qatar,Qatar,0,1,FIFA World Cup qualification,Doha,Qatar,2021,1,6,-1,1,1,1,loser,winner,1975,8,1,1,0.72101166,0.672130271
11/06/2021,11,Kuwait,Kuwait,Jordan,Jordan,0,0,FIFA World Cup qualification,Kuwait City,Kuwait,2021,1,6,0,0,0,0,draw,draw,1976,8,0,1,0.21284515,0.343286393
11/06/2021,11,Tunisia,Tunisia,Algeria,Algeria,0,2,Friendly,Radès,Tunisia,2021,1,6,-2,2,2,2,loser,winner,1977,8,1,1,0.7117828,0.616011955
15/06/2021,15,Palestine,Palestine,Yemen,Yemen,3,0,FIFA World Cup qualification,Riyadh,Saudi Arabia,2021,1,6,3,-3,3,3,winner,loser,1978,8,0,1,0.4990486,0.266849519
15/06/2021,15,Djibouti,Djibouti,Somalia,Somalia,1,0,Friendly,Djibouti City,Djibouti,2021,1,6,1,-1,1,1,winner,loser,1979,8,0,1,0.61862717,0.058624463
19/06/2021,19,Libya,Libya,Sudan,Sudan,0,1,FIFA Arab Cup qualification,Doha,Qatar,2021,1,6,-1,1,1,1,loser,winner,1980,8,0,1,0.80585408,0.512832541
20/06/2021,20,Oman,Oman,Somalia,Somalia,2,1,FIFA Arab Cup qualification,Doha,Qatar,2021,1,6,1,-1,1,3,winner,loser,1981,8,1,1,0.30764532,0.355881878
29/01/2019,29,Qatar,Qatar,UAE,UAE,4,0,AFC Asian Cup,Abu Dhabi,United Arab Emirates,2019,9,1,4,-4,4,4,winner,loser,1915,7,1,0,0.61052862,0.649328015
22/06/2021,22,Mauritania,Mauritania,Yemen,Yemen,2,0,FIFA Arab Cup qualification,Doha,Qatar,2021,1,6,2,-2,2,2,winner,loser,1983,8,1,1,0.17492214,0.761751615
23/06/2021,23,Lebanon,Lebanon,Djibouti,Djibouti,1,0,FIFA Arab Cup qualification,Doha,Qatar,2021,1,6,1,-1,1,1,winner,loser,1984,8,1,0,0.23415588,0.010353769
24/06/2021,24,Palestine,Palestine,Comoros,Comoros,5,1,FIFA Arab Cup qualification,Doha,Qatar,2021,1,6,4,-4,4,6,winner,loser,1985,8,0,1,0.25409819,0.059638685
25/06/2021,25,Bahrain,Bahrain,Kuwait,Kuwait,2,0,FIFA Arab Cup qualification,Doha,Qatar,2021,1,6,2,-2,2,2,winner,loser,1986,8,0,0,0.32791563,0.275082553
02/09/2021,2,Algeria,Algeria,Djibouti,Djibouti,8,0,FIFA World Cup qualification,Blida,Algeria,2021,1,9,8,-8,8,8,winner,loser,1987,8,1,0,0.09712064,0.072121605
02/09/2021,2,Morocco,Morocco,Sudan,Sudan,2,0,FIFA World Cup qualification,Rabat,Morocco,2021,1,9,2,-2,2,2,winner,loser,1988,8,0,1,0.69769489,0.706819263
02/09/2021,2,UAE,UAE,Lebanon,Lebanon,0,0,FIFA World Cup qualification,Dubai,United Arab Emirates,2021,1,9,0,0,0,0,draw,draw,1989,8,0,1,0.96579475,0.495807453
07/09/2021,7,Bahrain,Bahrain,Jordan,Jordan,1,2,Friendly,Riffa,Bahrain,2021,1,9,-1,1,1,3,loser,winner,1990,8,0,1,0.51956301,0.688937695
02/12/2019,2,Qatar,Qatar,UAE,UAE,4,2,Gulf Cup,Doha,Qatar,2019,9,12,2,-2,2,6,winner,loser,1947,7,1,0,0.09575911,0.087262404
07/09/2021,7,Syria,Syria,UAE,UAE,1,1,FIFA World Cup qualification,Amman,Jordan,2021,1,9,0,0,0,2,draw,draw,1991,8,0,0,0.83011578,0.278219443